{
Come on: ['comes', 'ejaculates', 'fallss', 'derives', 'doss'],
Requirements: ['demands', 'necessarys', 'requirements', 'demand', 'necessary'],
Responsibilities: ['province', 'responsibleness', 'responsibilitys', 'dutys', 'obligation'],
Working conditions: ['do_work', 'forge', 'cultivatess', 'exercises', 'gos'],
CSS: ['caesium', 'CSSs', 'atomic_number_55', 'atomic_number_55s', 'cesiums'],
We offer: ['bid', 'go', 'volunteer', 'proposes', 'offerss'],
go around: ['kick_the_bucket', 'conk_outs', 'travelss', 'X', 'plumps'],
Official employment: ['engagement', 'prescribed', 'functionarys', 'utilisations', 'usage'],
CV: ['CVs', 'one_hundred_five', 'cv', 'one_hundred_fives', '105s'],
HTML: ['hypertext_markup_language', 'HTML', 'hypertext_mark-up_language', 'hypertext_mark-up_languages', 'HTMLs'],
coffee: ['chocolates', 'coffee_berry', 'burnt_umbers', 'javas', 'coffee_bean'],
responsibility: ['province', 'responsibleness', 'responsibilitys', 'dutys', 'obligation'],
years: ['geezerhood', 'days', 'year', 'eld', 'geezerhoods'],
UAH: ['UAHs', 'UAH'],
Javascript: ['Javascript', 'Javascripts'],
Mi proponєmo: ['stat_mis', 'MIss', 'Military_Intelligence_Section_6ss', 'Great_Lakes_State', 'Security_Servicess'],
Responsibilities: ['province', 'responsibleness', 'responsibilitys', 'dutys', 'obligation'],
MySQL: ['MySQLs', 'MySQL'],
Schedule: ['Schedule', 'schedule', 'Schedules', 'agenda', 'schedules'],
plus: ['plus', 'pluss', 'positive', 'addition', 'positives'],
Requirements: ['demands', 'necessarys', 'requirements', 'demand', 'necessary'],
Vimogi: ['Vimogis', 'Vimogi'],
clients: ['customers', 'client', 'customer', 'clientss', 'guests'],
Obligations: ['Obligations', 'indebtedness', 'indebtednesss', 'responsibilitys', 'dutys'],
jQuery: ['jQuerys', 'jQuery'],
companies: ['companiess', 'company', 'fellowship', 'companies', 'partys'],
years of experience: ['agesss', 'geezerhood', 'have', 'live', 'lives'],
Linux: ['Linuxs', 'Linux'],
tea: ['Camellia_sinensiss', 'tea_leaf', 'afternoon_tea', 'teas', 'teatimes'],
Show phone: ['phoness', 'evidences', 'indicatess', 'phone', 'call_up'],
Will be a plus: ['testaments', 'berylliumss', 'leavess', 'willss', 'make_upss'],
x years: ['go', 'geezerhood', 'XTCs', 'disco_biscuits', 'exs'],
employees: ['employee', 'employeess', 'employees'],
vіdpovіdalnіst: ['vіdpovіdalnіst', 'vіdpovіdalnіsts'],
Wash robots: ['lap', 'races', 'moistenss', 'dampen', 'wash_drawings'],
rate: ['value', 'range', 'values', 'rank', 'orders'],
ability: ['power', 'powers', 'abilitys', 'ability'],
DNS: ['DNSs', 'DNS'],
professionals: ['pros', 'professionals', 'professional', 'masters', 'master'],
Tea: ['Tea', 'tea_leaf', 'Teas', 'Camellia_sinensiss', 'afternoon_tea'],
sociability: ['sociableness', 'sociabilitys', 'sociability', 'sociablenesss'],
Excel: ['stand_out', 'Excel', 'stand_outs', 'excel', 'excels'],
Personal qualities: ['qualitys', 'calibers', 'tone', 'Personalss', 'tones'],
Essential Skills: ['indispensables', 'requirements', 'essentialss', 'essential', 'necessity'],
fruit: ['fruit', 'fruits', 'yield', 'yields'],
Python: ['python', 'Pythons', 'pythons', 'Python'],
XML: ['XML', 'XMLs'],
Ukraine: ['Ukraines', 'Ukrayina', 'Ukrayinas', 'Ukraine'],
offices: ['powers', 'spots', 'bureaus', 'power', 'bureau'],
people: ['masses', 'mass', 'hoi_polloi', 'the_great_unwashed', 'multitude'],
countries: ['body_politic', 'countries', 'nation', 'rural_areas', 'body_politics'],
initiative: ['enterprises', 'opening_move', 'initiatives', 'first_step', 'first'],
Skill to work in team: ['inwardss', 'in', 'do_work', 'forge', 'body_of_workss'],
English: ['English', 'side', 'English_languages', 'English_language', 'Englishs'],
developers: ['developerss', 'developers', 'developer'],
Higher technical education: ['in_high_spiritssss', 'educationsss', 'eminentss', 'teaching', 'Department_of_Education'],
Show phone number: ['phoness', 'evidences', 'telephone_numbers', 'comes', 'indicatess'],
Friendly team: ['favorable', 'Friendly', 'team_ups', 'team_up', 'team'],
human: ['human_beings', 'homo', 'human_being', 'man', 'homos'],
Ofіtsіyne pratsevlashtuvannya: ['Ofіtsіynes', 'Ofіtsіyness', 'pratsevlashtuvannyas', 'pratsevlashtuvannyass', 'pratsevlashtuvannya'],
responsibility: ['province', 'responsibleness', 'responsibilitys', 'dutys', 'obligation'],
vul: ['vul', 'vuls'],
Belarus: ['Byelarus', 'Byelorussia', 'Byelaruss', 'Republic_of_Belaruss', 'Belorussias'],
USA: ['Americas', 'US_Army', 'the_Statess', 'United_Statess', 'USA'],
Google: ['googles', 'Googles', 'google', 'Google'],
businesses: ['business_organizations', 'lines', 'business_enterprises', 'clienteles', 'business_organization'],
place: ['range', 'set', 'orders', 'stations', 'piazza'],
vacation: ['vacations', 'vacation', 'holidays', 'holiday'],
management: ['managements', 'management', 'direction', 'directions'],
rock: ['John_Rock', 'tilts', 'rock_candy', 'sways', 'rocks'],
Facebook: ['Facebook', 'Facebooks'],
Tasks: ['project', 'jobs', 'undertakings', 'job', 'task'],
x rock: ['John_Rock', 'go', 'rockss', 'XTCs', 'tilts'],
opportunity: ['chances', 'opportunitys', 'chance', 'opportunity'],
world: ['world-wide', 'human_race', 'mans', 'worldwides', 'earthly_concern'],
Apache: ['Apaches', 'Apache', 'apaches', 'apache'],
weekends: ['weekendss', 'weekend', 'weekends'],
Functionality: ['Functionalitys', 'Functionality', 'functionality', 'functionalitys'],
MS Office: ['powers', 'Ms.', 'Mississippiss', 'molar_concentrations', '1000s'],
Laravel: ['Laravel', 'Laravels'],
preferably: ['rathers', 'preferablys', 'preferably', 'sooner', 'rather'],
Git: ['scum_bags', 'stinkpots', 'scum_bag', 'dirty_dogs', 'lowlife'],
Kyiv: ['Kyiv', 'Kyivs'],
cookies: ['biscuit', 'cookys', 'cookiess', 'cookie', 'cookies'],
package: ['parcels', 'software_system', 'box', 'boxs', 'software_programs'],
Json: ['Json', 'Jsons'],
coffee: ['chocolates', 'coffee_berry', 'burnt_umbers', 'javas', 'coffee_bean'],
Jenkins: ['Jenkins', 'Jenkinss'],
Primary requirements: ['main', 'chief', 'requirements', 'elementarys', 'primaryss'],
Oop: ['Oops', 'Oop'],
Nginx: ['Nginxs', 'Nginx'],
SQL: ['SQL', 'SQLs'],
Maven: ['aces', 'superstar', 'stars', 'star', 'mavins'],
official registration: ['prescribed', 'functionarys', 'enrollment', 'enrolments', 'readjustments'],
Variety of knowledge sharing: ['miscellaneasss', 'motleyssss', 'partakes', 'ofsss', 'varietyss'],
hundreds of world: ['world-wide', '100sss', 'humankinds', 'realitys', 'ofsss'],
Children’s Cardiac Center: ['gists', 'centers', 'cardiacss', 'centre_of_attention', 'focus_on'],
Poland: ['Polands', 'Republic_of_Poland', 'Poland', 'Republic_of_Polands', 'Polskas'],
Intel: ['Intels', 'Intel'],
Spain: ['Espana', 'Kingdom_of_Spains', 'Espanas', 'Kingdom_of_Spain', 'Spain'],
Smart defibrillator: ['wisess', 'hurts', 'sassys', 'chics', 'aches'],
winner: ['succeeder', 'victors', 'success', 'winners', 'achievers'],
Micron: ['micrometer', 'micron', 'Microns', 'microns', 'micrometers'],
full-time basis: ['bases', 'basis', 'base', 'full-time', 'groundwork'],
Vital signs monitor: ['signal', 'sign_of_the_zodiacss', 'vitals', 'criticalss', 'mansion'],
delivery centers: ['centersss', 'gists', 'centers', 'centre_of_attention', 'focus_on'],
technology partner: ['spouse', 'technologyss', 'cooperator', 'partners', 'engineeringss'],
global software engineering: ['world-wide', 'sphericals', 'engineeringss', 'software_programs', 'engineering'],
Solutions company: ['company', 'answerss', 'fellowship', 'solvent', 'resultss'],
cool things ciklumers: ['coolheaded', 'ciklumerssss', 'aplombsss', 'things', 'cools'],
tech ideas tangible: ['idea', 'mind', 'themess', 'ideas', 'mindss'],
unique possibility: ['singular', 'possible_action', 'uniquess', 'unparalleledss', 'unequaleds'],
Extended teams: ['prolongss', 'put_outs', 'team_up', 'poke_outs', 'reach_outss'],
industry: ['industry', 'manufactures', 'industriousnesss', 'industrys', 'industriousness'],
day: ['daylights', 'days', 'daytimes', 'sidereal_day', 'sidereal_days'],
Planning: ['project', 'preparations', 'plan', 'preparation', 'be_after'],
Computer science: ['estimator', 'calculators', 'reckoner', 'figurerss', 'electronic_computer'],
snacks: ['snack', 'noshs', 'snacks', 'collation', 'bite'],
Monday through Friday: ['Fri', 'Fridayss', 'dones', 'Mondayss', 'done'],
Confident PC user: ['microcomputerss', 'positives', 'convinced', 'sure-footedsss', 'surefooted'],
Ability: ['powers', 'Abilitys', 'power', 'abilitys', 'ability'],
customer: ['client', 'customers', 'customer', 'clients'],
Kiev: ['Kyyiv', 'capital_of_the_Ukraine', 'Kievs', 'capital_of_the_Ukraines', 'Kyyivs'],
PostgreSQL: ['PostgreSQL', 'PostgreSQLs'],
order: ['range', 'edicts', 'orders', 'regulate', 'fiats'],
career: ['career', 'calling', 'vocations', 'life_history', 'careers'],
mission: ['delegation', 'missionary_station', 'military_mission', 'deputation', 'charge'],
goals: ['ends', 'finish', 'destinations', 'end', 'goal'],
position: ['spots', 'set', 'posture', 'postures', 'stances'],
benefits: ['welfare', 'benefits', 'gain', 'profits', 'welfares'],
based on interview results: ['foundss', 'resultss', 'outcomes', 'establishs', 'questionss'],
Honey: ['love', 'dears', 'honeys', 'honey', 'beloved'],
IOS: ['Io', 'IOS', 'IOSs', 'Ios'],
professional development: ['professionals', 'growth', 'master', 'growths', 'masterss'],
key role: ['cays', 'tonalityss', 'paints', 'paint', 'cardinalss'],
job: ['lines', 'Jobs', 'jobs', 'speculates', 'Book_of_Job'],
Lukyanovskaya: ['Lukyanovskayas', 'Lukyanovskaya'],
respect: ['obediences', 'respectfulnesss', 'respect', 'abide_by', 'honour'],
Analytical warehouse for rosum: ['analyticss', 'analyticals', 'forsss', 'Analytical', 'analytical'],
Corporate Mobile Sound: ['corporatesss', 'reasoned', 'wakelesss', 'phone', 'incarnatesss'],
sick leave: ['forget', 'regorges', 'cats', 'leavess', 'bequeaths'],
SOAP: ['scoop', 'maxs', 'easy_lay', 'lathers', 'easy_lays'],
Our candidate: ['campaigners', 'Our', 'candidatess', 'prospect', 'nominees'],
chance: ['fortunes', 'casual', 'fortune', 'luck', 'happen'],
ES6: ['ES6', 'ES6s'],
benevolence: ['benefaction', 'benevolences', 'benefactions', 'benevolence'],
expertise: ['expertnesss', 'expertises', 'expertise', 'expertness'],
Health insurance: ['insurancess', 'policy', 'Health', 'indemnity', 'healthss'],
Docker: ['stevedore', 'loader', 'longshoremans', 'docker', 'Docker'],
projects: ['project', 'visualize', 'externalises', 'contrives', 'undertaking'],
Ajax: ['Ajaxs', 'Ajax'],
presentations: ['display', 'intros', 'demonstrations', 'presentation', 'presentationss'],
Official registration: ['prescribed', 'functionarys', 'enrollment', 'Officials', 'enrolments'],
skill to work in team: ['inwardss', 'in', 'do_work', 'forge', 'body_of_workss'],
Work experience from: ['do_work', 'forge', 'body_of_workss', 'operatesss', 'studys'],
Higher education: ['teaching', 'eminentss', 'Department_of_Education', 'gamey', 'eminents'],
Flexible schedule: ['Flexibles', 'elasticss', 'pliable', 'scheduless', 'compromisings'],
attention: ['aids', 'care', 'tending', 'attention', 'attending'],
products: ['product', 'production', 'ware', 'intersection', 'wares'],
Contacts: ['link', 'touchs', 'meets', 'physical_contact', 'Contactss'],
salary: ['wage', 'earnings', 'salarys', 'salary', 'remuneration'],
Posada: ['Posada', 'Posadas'],
SOLID: ['SOLIDs', 'solids', 'solid_state', 'satisfying', 'upstandings'],
Word: ['Good_Book', 'Holy_Writ', 'intelligences', 'articulate', 'Son'],
troubleshootingGood knowledge: ['cognition', 'cognitions', 'knowledges', 'knowledgess', 'knowledge'],
Tomcat: ['tom', 'Tomcat', 'toms', 'tomcat', 'tomcats'],
What do we offer: ['set', 'comes', 'bashss', 'answerss', 'pass'],
ZP: ['ZP', 'ZPs'],
truthfulness and summarized: ['summarizedss', 'summarized', 'summarises', 'sum_up', 'and'],
Robot at the Company: ['automatonsss', 'golemss', 'Atss', 'company', 'automaton'],
policy and procedures Company: ['functionss', 'insurance_policysss', 'company', 'procedures', 'policyss'],
Entrance to the Group of companies VEON: ['tosssssss', 'catchsssssss', 'Entrancess', 'beguiless', 'spellbindsss'],
Yakimi guilty Keruvatisya afіlіovovany company Group VEON: ['companysssssss', 'guiltyssss', 'company', 'afіlіovovany', 'hangdogsssss'],
Vikonannya Code of Conduct Group VEON: ['computer_codes', 'channelss', 'enciphersssss', 'ofsss', 'write_in_code'],
suvorogo dotrimannya all legal goiter’s and our values: ['altogetherssssss', 'appreciate', 'altogetherss', 'totallysss', 'soundsss'],
vimagaє vid us: ['Americas', 'vidss', 'the_Statess', 'vimagaєs', 'U'],
що vimagaє vid of the ethical: ['vimagaєssss', 'vidss', 'ethicalss', 'thes', 'vimagaєs'],
Qualification of vimogi before the candidates: ['campaigners', 'Qualificationss', 'beforesss', 'ofsss', 'reservationsssss'],
Dosvіd robots no less: ['automatonsss', 'to_a_lesser_extents', 'golemss', 'nossss', 'nobeliumss'],
Pіdpriєmnitsky spirit: ['Pіdpriєmnitsky', 'tone', 'intent', 'feels', 'tones'],
Our leadership spirit is in five values: ['fivessssss', 'disembodied_spiritsssss', 'leadingsssss', 'purportsssss', 'inspirits'],
zokrem: ['zokrem', 'zokrems'],
high quality standards for business ethics: ['choicesssss', 'high_gearsss', 'characterss', 'standardssssss', 'highssss'],
Mi wait for pragnemo buti garlic: ['stat_mis', 'hold_backss', 'delaysss', 'waitings', 'Military_Intelligence_Section_6sss'],
Klіnti: ['Klіnti', 'Klіntis'],
our addiction: ['dependency', 'addiction', 'addictionss', 'ourss', 'dependance'],
Інноваційність: ['Інноваційністьs', 'Інноваційність'],
Spivpratsya: ['Spivpratsyas', 'Spivpratsya'],
Chesnіst: ['Chesnіsts', 'Chesnіst'],
working-days: ['working-dayss', 'working-days'],
IoT World Hackathon: ['world-wide', 'World', 'humankinds', 'realitys', 'Worlds'],
action plans: ['project', 'actionss', 'program', 'be_after', 'programs'],
installation: ['inductions', 'facilitys', 'initiation', 'installment', 'facility'],
successful companyLong-term employment: ['engagement', 'utilisations', 'successfulss', 'usage', 'utilizations'],
desire: ['want', 'trust', 'hopes', 'desires', 'trusts'],
environment: ['environment', 'surround', 'environs', 'surrounds', 'environments'],
Ciklum’s employee: ['employeess', 'Ciklum’sss', 'employees', 'employee', 'Ciklum’s'],
warm atmosphere: ['lovesomess', 'fondss', 'lovesomes', 'warms', 'air'],
work: ['do_work', 'forge', 'studys', 'exercises', 'gos'],
value: ['appreciate', 'respect', 'treasure', 'prizes', 'treasures'],
brief description: ['description', 'brief', 'briefss', 'abbreviateds', 'descriptions'],
line: ['delineates', 'lines', 'melodic_lines', 'crease', 'ancestry'],
B2B: ['B2B', 'B2Bs'],
B2C: ['B2C', 'B2Cs'],
Salary: ['wage', 'earnings', 'pays', 'remuneration', 'salary'],
passion: ['rages', 'passions', 'heats', 'warmths', 'love'],
revenue: ['tax_revenues', 'taxations', 'revenue', 'taxation', 'receiptss'],
ideas: ['idea', 'mind', 'ideas', 'melodic_theme', 'estimate'],
Result orientation: ['Results', 'ensue', 'terminationss', 'final_results', 'leavess'],
Desirable: ['suitables', 'desirable', 'worthys', 'suitable', 'Desirables'],
Php: ['Php', 'Phps'],
Js: ['Js', 'joules', 'watt_seconds', 'joule', 'watt_second'],
if necessary: ['necessitys', 'requirements', 'necessary', 'necessaryss', 'requisite'],
accounts: ['news_report', 'write_ups', 'describe', 'report', 'scores'],
issues: ['put_outs', 'return', 'outcomes', 'issuing', 'come_forth'],
Telegram: ['wire', 'telegrams', 'Telegram', 'telegram', 'wires'],
Vishcha bless: ['consecrates', 'hallows', 'bless', 'Vishchas', 'sanctify'],
Power BI: ['powers', 'major_powerss', 'mights', 'top_executive', 'major_powers'],
stakeholders: ['stakeholders', 'stakeholder', 'stakeholderss'],
organizational skills: ['skillss', 'organisationals', 'skillsss', 'skill', 'science'],
technology: ['engineerings', 'engineering_sciences', 'engineering_science', 'applied_sciences', 'technologys'],
fruits: ['fruitss', 'fruit', 'yield', 'yields', 'fruits'],
person: ['somebody', 'mortal', 'persons', 'person', 'someones'],
email: ['emails', 'electronic_mails', 'e-mails', 'e-mail', 'electronic_mail'],
Wordpress: ['Wordpress', 'Wordpresss'],
week: ['workweeks', 'calendar_weeks', 'calendar_week', 'workweek', 'hebdomads'],
role: ['use', 'theatrical_role', 'purposes', 'uses', 'purpose'],
weeks: ['workweeks', 'calendar_weeks', 'calendar_week', 'weekss', 'workweek'],
With ZUP: ['ZUPs', 'Withs', 'Withss', 'With', 'ZUPss'],
Interaction with participants in the development and implementation project: ['inwardss', 'in', 'maturationss', 'externalises', 'implementation'],
Sociability and conflict-free: ['sociablenesssss', 'and', 'andsss', 'sociabilitysss', 'Sociabilitys'],
Responsibility and Obligation: ['dutysss', 'Responsibilitys', 'duty', 'and', 'andsss'],
Ability to work with XDTO packages: ['powers', 'do_work', 'forge', 'body_of_workss', 'operatesss'],
Experience optimizing code and queries: ['computer_codes', 'write_in_code', 'seessss', 'encryptss', 'havesss'],
Participation in formalization and coordination of requirements: ['inwardss', 'in', 'requirementss', 'involution', 'engagementsssssss'],
Experience in supporting and developing typical configurations: ['uprise', 'risesss', 'keep_going', 'explicate', 'brook'],
WEB and HTTP services: ['entanglementsss', 'World_Wide_Web', 'HTTPss', 'World_Wide_Websss', 'Service'],
Organization of development of applied solutions taking into account development standards: ['accountsss', 'makessss', 'constitution', 'use_up', 'learnsssss'],
Knowledge and ability to put into practice the query language: ['tosssssss', 'investssss', 'powerss', 'querysss', 'recitation'],
High responsibility and result orientation: ['high_gearsss', 'highssss', 'leavess', 'richlysssss', 'answerss'],
Decent salary and professional development: ['professionalssss', 'decentlyssss', 'comme_il_faut', 'wagess', 'decent'],
Programmer Experience: ['Experiencess', 'have', 'computer_programmer', 'live', 'lives'],
Skill to understand someone else's code: ['computer_codes', 'mortal', 'realises', 'realizes', 'write_in_code'],
Participation in automation projects of a large enterprise based on a family of software products: ['jutsss', 'bombasticssssss', 'envisionssssssssssss', 'laborssssss', 'laborsssssssssss'],
Implement custom configurations: ['Implement', 'follow_outsss', 'follow_through', 'follow_outs', 'implement'],
The advantage will be the availability of certificates: ['vantagesss', 'accessibilitys', 'testaments', 'equalsssss', 'berylliumss'],
Company: ['company', 'fellowship', 'Company', 'partys', 'party'],
Specialist: ['specialisers', 'specializer', 'Specialists', 'specialists', 'medical_specialists'],
Mon-Fri: ['Mon-Fri', 'Mon-Fris'],
Windows: ['window', 'windowpanes', 'windows', 'Windows', 'Windowss'],
activities: ['bodily_functions', 'activities', 'bodily_function', 'natural_process', 'body_processs'],
Competitive salary: ['wage', 'private-enterprises', 'competitoryss', 'salaryss', 'Competitives'],
times: ['time', 'clock_times', 'multiplication', 'prison_terms', 'multiplications'],
chat: ['Old_World_chats', 'Old_World_chat', 'natters', 'confabs', 'confab'],
Knowledge of English: ['cognitionsss', 'cognitions', 'ofsss', 'English_language', 'English_peoples'],
Fast learner: ['profligate', 'prentice', 'loyals', 'truehearteds', 'debaucheds'],
IP: ['IP', 'information_processings', 'informaticss', 'information_science', 'informatics'],
TCP: ['TCP', 'TCPs', 'transmission_control_protocol', 'transmission_control_protocols'],
Email: ['emails', 'electronic_mails', 'e-mails', 'Email', 'e-mail'],
and we do it with great pleasure: ['makessss', 'comes', 'exercises', 'exercisesssss', 'expectant'],
We are sure: ['representss', 'comprisess', 'live', 'lives', 'trusteds'],
We are a community of creative dreamers and professional gamers: ['constitutessssss', 'existssss', 'bes', 'aressss', 'gamersss'],
according to the work book: ['do_work', 'forge', 'body_of_workss', 'Holy_Writ', 'studys'],
that talented people need to be inspired: ['tosssssss', 'barracks', 'pep_ups', 'postulates', 'hoi_pollois'],
That is why our Hidden Object games are the most exciting.: ['Objectsssssssssss', 'aboutss', 'Hiddenss', 'constitutessssss', 'game'],
corp: ['corps', 'corporation', 'corporations', 'corp'],
shared by a common passion: ['divvy_upsssss', 'axerophtholsss', 'divideds', 'divided_upss', 'rages'],
check lists: ['hold_backss', 'hindrancess', 'breaks', 'chequers', 'check_markss'],
sick leave payment: ['forget', 'regorges', 'cats', 'leavess', 'crazysss'],
international company: ['company', 'outsides', 'internationals', 'Internationals', 'International'],
Flexible working hours: ['do_work', 'forge', 'cultivatess', 'exercises', 'pliants'],
year: ['yr', 'twelvemonths', 'years', 'class', 'year'],
Paid Lunches: ['Lunches', 'ante_up', 'Lunchesss', 'payings', 'devotes'],
Amazon: ['Amazons', 'amazon', 'virago', 'amazons', 'Amazon_Rivers'],
great opportunity: ['keen', 'dandys', 'large', 'peachyss', 'not_badss'],
team: ['teams', 'squads', 'team', 'team_ups', 'team_up'],
Windows server: ['windowss', 'host', 'window', 'windowpanes', 'windows'],
punctuality: ['promptnesss', 'punctualitys', 'promptness', 'punctuality'],
dnі dієti: ['dnіs', 'dієtiss', 'dnіss', 'dієtis', 'dnі'],
We have comfortable pratsuvati: ['deliverss', 'well-fixedss', 'possesssss', 'wealthy_personss', 'take_in'],
calendar days paid: ['calendarss', 'daylightss', 'ante_up', 'daylights', 'twenty-four_hoursss'],
Balance between work and especially: ['poisesssss', 'forge', 'equilibriumsss', 'equilibriumss', 'Balancesssss'],
companies of happy people: ['company', 'hoi_pollois', 'ofsss', 'companionssss', 'party'],
For you: ['For', 'youss', 'Fors', 'yous', 'you'],
mi pracevlashtovumo ofitsyno: ['stat_mis', 'Military_Intelligence_Section_6sss', 'myocardial_infarcts', 'international_nautical_mile', 'knotsss'],
Strengthen your resume on electronic mail: ['take_upssss', 'curriculum_vitaess', 'electronicssss', 'tone_upss', 'fortify'],
Comfortable smarts: ['well-situateds', 'prosperousss', 'well-to-doss', 'easyss', 'hurts'],
tse is important: ['representss', 'tses', 'comprisess', 'importantss', 'live'],
Kava: ['Kava', 'kavas', 'kavakavas', 'Kavas', 'kava'],
ETL: ['ETLs', 'ETL'],
telephone: ['ring', 'telephone_set', 'phones', 'calls', 'telephone'],
of the month: ['thess', 'ofs', 'calendar_months', 'thes', 'ofss'],
Contract area: ['abbreviate', 'constrict', 'reducess', 'squeeze', 'squeezes'],
C #: ['snow', 'one_C', 'snowss', '#', 'nose_candy'],
MVC: ['MVCs', 'MVC'],
REST: ['rests', 'relief', 'remain', 'relaxations', 'residuals'],
Paying for work experience: ['do_work', 'ante_up', 'forge', 'body_of_workss', 'studys'],
of the year: ['thess', 'yr', 'twelvemonths', 'ofs', 'twelvemonth'],
professional growth: ['growth', 'professionals', 'master', 'growths', 'masterss'],
great plus: ['keen', 'dandys', 'asset', 'large', 'peachyss'],
globe: ['orbs', 'world', 'ball', 'globe', 'Earths'],
business needs: ['lines', 'postulates', 'needs', 'motivations', 'jobs'],
actions: ['actionss', 'accomplish', 'carry_through', 'activitys', 'carry_out'],
impact: ['touchs', 'bear_upon', 'bear_ons', 'impingements', 'encroachments'],
integrity: ['unitys', 'integritys', 'integrity', 'unity', 'wholenesss'],
Gitlab: ['Gitlabs', 'Gitlab'],
Redis: ['Redis', 'Rediss'],
And our main goal: ['main', 'mainssss', 'independentss', 'goal', 'ourss'],
to be leaders in their field: ['inwardss', 'in', 'studys', 'equalsssss', 'berylliumss'],
We are a real team: ['axerophtholsss', 'team_up', 'make_upss', 'reals', 'comprises'],
new features: ['boasts', 'feature_articles', 'have', 'New', 'newlys'],
future: ['future_tense', 'futurity', 'futuritys', 'next', 'nexts'],
Paid holiday: ['holidays', 'ante_up', 'pay_upss', 'payings', 'devotes'],
client: ['customers', 'client', 'customer', 'guests', 'nodes'],
ES5: ['ES5s', 'ES5'],
Google analytics: ['analytics', 'Google', 'analyticss', 'Googless', 'analyticsss'],
food company: ['nutrient', 'company', 'fellowship', 'food', 'partys'],
web: ['network', 'vanes', 'WWWs', 'World_Wide_Web', 'networks'],
css: ['caesium', 'csss', 'atomic_number_55', 'atomic_number_55s', 'cesiums'],
escort and meetings: ['foregather', 'meetingsss', 'meetingssss', 'escorts', 'run_acrosss'],
Europe and North America: ['compass_norths', 'Europesss', 'European_Economic_Community', 'European_Community', 'ECs'],
cybersecurity and information security: ['infos', 'cybersecurity', 'cybersecurityss', 'security_systems', 'information'],
Participation in workshops and trainings within the company: ['Indianasssssss', 'participationssss', 'take_aimsss', 'Inssssss', 'Participation'],
Ability to implement your proposals and innovations: ['powers', 'tosssssss', 'follow_throughsssss', 'Abilitysssssss', 'follow_outsss'],
Participation in competitions within the company to identify and implement creative initiatives: ['tosssssss', 'competitorsssssss', 'contestssssssss', 'challengerssssssssss', 'Indianasssssss'],
If you are interested in career and professional growth in our company: ['Indianasssssss', 'interestedssssss', 'Inssssss', 'constitutessssss', 'careerssssssssssss'],
Work support: ['do_work', 'forge', 'keep_going', 'body_of_workss', 'studys'],
and to enable business to keep up to date: ['celebrates', 'tosssssss', 'celebratess', 'hold_ons', 'stay_freshsss'],
ADVANTAGES OF WORK IN OUR COMPANY: ['COMPANYssssss', 'forge', 'makessss', 'exercises', 'atomic_number_49s'],
Full official employment and security according to the Labor Code: ['tosssssss', 'lying-in', 'usagessssss', 'officialssssssssss', 'widess'],
including sports: ['boasts', 'frolic', 'mutation', 'disports', 'sportsmans'],
digitally transforming large business in Ukraine: ['inwardss', 'in', 'lines', 'bombastics', 'tumidsss'],
with manager: ['withs', 'with', 'managerss', 'handlers', 'withss'],
Information technology in the modern world is crucial: ['technologysssss', 'world-wide', 'entropysss', 'engineeringsssss', 'Modernsss'],
Acquiring the ability to perform complex tasks within one large product: ['tosssssss', 'acquiringssssss', 'learnsssss', 'powerss', 'taxss'],
implementation of information systems: ['infos', 'effectuations', 'implementation', 'carrying_outs', 'information'],
Strong interaction: ['fundamental_interaction', 'securess', 'unassailabless', 'interactions', 'solids'],
successful Ukrainian IT company: ['information_technologyss', 'company', 'successfulss', 'ITssss', 'companyssss'],
we will gladly consider your candidacy: ['considersssss', 'turn_overss', 'studys', 'testaments', 'leavess'],
KEY TASKS: ['cays', 'tonalityss', 'paints', 'paint', 'jobs'],
Key competencies: ['winder', 'cays', 'names', 'fundamentals', 'distinguishss'],
as well as improving existing skills together with our team: ['existentsssss', 'atomic_number_33ssssss', 'team_up', 'teamsssssss', 'atomic_number_33ss'],
Competitive salary with flexible bonus system: ['wagess', 'free-enterprisessss', 'militantsss', 'systemss', 'pliants'],
WHAT DO WE OFFER: ['WEs', 'set', 'OFFERssss', 'comes', 'bashss'],
Key Performance Indicators: ['cays', 'tonalityss', 'paints', 'indicant', 'paint'],
open-minded team: ['teams', 'open-mindedss', 'squads', 'open-minded', 'team'],
system integration: ['integration', 'desegregation', 'integrations', 'systemss', 'systems'],
which is paid by the company: ['ante_up', 'company', 'devotes', 'equalsssss', 'make_upss'],
specialized conferences: ['specializedss', 'narrow', 'specialisedss', 'conferencess', 'conference'],
Systemic thinking: ['suppose', 'recollects', 'imagine', 'thinkings', 'means'],
Corporate Mobile: ['corporatess', 'incarnates', 'peregrines', 'collectives', 'Corporate'],
proactive: ['proactives', 'proactive'],
outsourcing: ['outsources', 'outsourcings', 'outsource', 'outsourcing'],
Percentage of business trips from working hours: ['tripper', 'forge', 'percentage', 'linessss', 'exercises'],
Periodic corporate events: ['corporatess', 'corporatesss', 'occasionalss', 'incarnates', 'eventsss'],
Metinvest digital: ['Metinvests', 'digitals', 'digitalss', 'Metinvest', 'Metinvestss'],
Forward: ['send_ons', 'forrader', 'advancings', 'onwardss', 'onwards'],
Basic Obligations: ['stapless', 'Basicss', 'canonicalss', 'Basic', 'BASIC'],
Akuratnіst: ['Akuratnіst', 'Akuratnіsts'],
food: ['solid_foods', 'nutrient', 'foods', 'solid_food', 'intellectual_nourishment'],
systems: ['organisation', 'arrangements', 'system', 'scheme', 'arrangement'],
University: ['Universitys', 'university', 'universitys', 'University'],
Lviv square: ['squaress', 'solids', 'feathers', 'straightforward', 'Lvivs'],
data mining: ['datum', 'excavation', 'information', 'excavations', 'data_point'],
Ljubljana: ['Ljubljana', 'Ljubljanas'],
Main responsibilities: ['main', 'independentss', 'chief', 'primaryss', 'master'],
details: ['item', 'inside_information', 'particular', 'detailss', 'points'],
company: ['company', 'fellowship', 'partys', 'party', 'keep_company'],
Unix: ['UNIX_system', 'UNIX', 'Unix', 'Unixs', 'UNIX_operating_systems'],
Mikrotik: ['Mikrotiks', 'Mikrotik'],
Android: ['mechanical_man', 'android', 'humanoid', 'mechanical_mans', 'Android'],
Decent salary: ['adequate', 'wage', 'decents', 'comme_il_faut', 'decorousss'],
agile methodologies: ['nimbles', 'methodology', 'nimbless', 'quick', 'sprys'],
colleagues: ['co-workers', 'colleague', 'fellow_worker', 'fellow', 'colleaguess'],
challenges: ['challenge', 'gainsays', 'disputes', 'take_exception', 'gainsay'],
software development: ['growth', 'software_programss', 'software_system', 'growths', 'evolutions'],
Git: ['scum_bags', 'stinkpots', 'scum_bag', 'dirty_dogs', 'lowlife'],
HTTP: ['HTTPs', 'hypertext_transfer_protocols', 'hypertext_transfer_protocol', 'HTTP'],
skills: ['skillss', 'acquirements', 'sciences', 'acquisition', 'attainment'],
Social package: ['parcels', 'societalss', 'mixers', 'software_system', 'societal'],
marketing: ['merchandising', 'commercialize', 'marketing', 'market', 'commercialises'],
Oracle: ['Oracles', 'prophesier', 'seer', 'vaticinator', 'prophesiers'],
MS SQL: ['Ms.', 'Mississippiss', 'molar_concentrations', '1000s', 'Gs'],
Skills: ['acquirements', 'sciences', 'Skills', 'acquisition', 'attainment'],
scratch: ['cabbages', 'breads', 'scrapings', 'cancel', 'starts'],
Java: ['Javas', 'javas', 'coffees', 'Java', 'java'],
High salary: ['wage', 'heightss', 'high_upss', 'eminentss', 'senior_high_school'],
friendly team: ['teams', 'well-disposeds', 'favorable', 'squads', 'well-disposedss'],
official employment: ['engagement', 'prescribed', 'functionarys', 'utilisations', 'usage'],
advantage: ['rewards', 'vantage', 'vantages', 'advantage', 'advantages'],
Law of Ukraine: ['Ukrayina', 'lawsss', 'jurisprudences', 'natural_laws', 'constabularysss'],
About power service: ['powers', 'Abouts', 'kings', 'aboutss', 'powerss'],
Wash pay pra: ['ante_up', 'devotes', 'wagess', 'make_upss', 'laves'],
fierce: ['fierces', 'boisterous', 'cutthroats', 'bowelless', 'violents'],
Term_n filing applications: ['application_program', 'applications_programme', 'Term_nss', 'files', 'Term_ns'],
competitive salary: ['wage', 'private-enterprises', 'competitoryss', 'salaryss', 'free-enterprises'],
implementation: ['effectuations', 'implementation', 'carrying_outs', 'implementations', 'effectuation'],
json: ['json', 'jsons'],
xml: ['xml', 'xmls'],
innovation: ['excogitation', 'instauration', 'initiations', 'excogitations', 'innovations'],
comfortable office: ['well-situateds', 'powers', 'spots', 'prosperousss', 'well-to-doss'],
knowledge: ['cognition', 'cognitions', 'knowledges', 'knowledge', 'noesiss'],
logs: ['logarithms', 'logs', 'lumber', 'lumbers', 'logss'],
bash: ['sock', 'whap', 'smash', 'whops', 'bangs'],
social: ['mixers', 'societal', 'sociable', 'social', 'societals'],
Schedule: ['Schedule', 'schedule', 'Schedules', 'agenda', 'schedules'],
Komunіkabelіst: ['Komunіkabelіst', 'Komunіkabelіsts'],
communication: ['communicatings', 'communication', 'communications', 'communicating'],
training: ['condition', 'develops', 'cultivate', 'training', 'prepares'],
Pop: ['pa', 'Pops', 'dadas', 'crop_up', 'popping'],
Ci: ['curie', 'one_hundred_one', 'Cis', '101', 'ci'],
Education: ['teaching', 'Department_of_Education', 'training', 'Education_Department', 'didacticss'],
Monday to Friday with: ['Fri', 'Fridayss', 'Monsss', 'Mondayss', 'withssss'],
Spring boot: ['spring', 'iron_heel', 'take_a_hop', 'recoilss', 'boot'],
Spring security: ['spring', 'take_a_hop', 'recoilss', 'jumpss', 'bouncess'],
Kiev: ['Kyyiv', 'capital_of_the_Ukraine', 'Kievs', 'capital_of_the_Ukraines', 'Kyyivs'],
that we reviewed your resume: ['reexamines', 'reviewedss', 'sketch', 'wesss', 'brush_ups'],
No response for: ['reception', 'forsss', 'nobeliumss', 'atomic_number_102sss', 'Nosss'],
In case of opening a relevant vacancy: ['characterss', 'opening_movess', "typesetter's_case", 'incasess', 'Indianasssssss'],
according to your qualifications and wishes: ['accordssssss', 'fit_inss', 'bids', 'consortssssss', 'allotssssss'],
we will offer you it for consideration: ['testaments', 'leavess', 'willss', 'proposes', 'bequeaths'],
today the company has no vacancies: ['deliverss', 'company', 'nossss', 'hour_anglesss', 'possesssss'],
from sales: ['froms', 'sale', 'sales_agreement', 'gross_revenues', 'cut-rate_sales'],
Standard resume review period: ['bannerssss', 'bannersss', 'reexaminationss', 'curriculum_vitaess', 'critical_reviews'],
days means: ['daylightss', 'entails', 'daylights', 'substance', 'mean_value'],
Unfortunately: ['alass', 'unfortunately', 'Unfortunatelys', 'unluckilys', 'unluckily'],
Training: ['condition', 'develops', 'cultivate', 'training', 'prepares'],
more: ['More', 'Sir_Thomas_Mores', 'mores', 'to_a_greater_extent', 'more_than'],
Mon-Fri: ['Mon-Fri', 'Mon-Fris'],
schedule: ['schedule', 'agenda', 'schedules', 'docket', 'agendas'],
Basic Functionality: ['Functionalitys', 'stapless', 'Basicss', 'Functionality', 'canonicalss'],
Artificial Intelligence: ['artificialss', 'unreals', 'intelligences', 'intelligence_services', 'unreal'],
Kyiv team: ['teams', 'squads', 'Kyivs', 'Kyivss', 'team'],
good working conditionsWork: ['trade_good', 'do_work', 'forge', 'securess', 'skillful'],
large number of customers: ['telephone_numbers', 'telephone_numberss', 'comes', 'ofsss', 'bombastics'],
research: ['enquiry', 'inquirys', 'enquirys', 'researchs', 'searchs'],
certifications: ['authentications', 'authentication', 'documentations', 'certificate', 'credentials'],
multitasking: ['multitaskings', 'multitasking'],
various approaches: ['approach', 'coming', 'glide_paths', 'comings', 'glide_slope'],
documentationRequirements: ['documentationRequirements', 'documentationRequirementss'],
technologies: ['technologiess', 'engineerings', 'engineering_sciences', 'engineering_science', 'applied_sciences'],
quality assurance: ['qualitys', 'characterss', 'calibers', 'self-confidence', 'choicess'],
training opportunitiesUnique: ['condition', 'develops', 'cultivate', 'opportunitiesUniques', 'cultivatess'],
professional growthPossibility: ['pros', 'professionals', 'professional', 'masters', 'master'],
social benefitsWorking: ['societalss', 'mixers', 'societal', 'sociable', 'socialss'],
clientCompetitive salaryCareer: ['salaryCareers', 'clientCompetitive', 'clientCompetitivess', 'clientCompetitives', 'salaryCareerss'],
Borders: ['borderlines', 'skirt', 'moldings', 'frames', 'surround'],
partners' business: ['business_organizations', "partners's", 'lines', 'business_enterprises', 'clienteles'],
world trust webhelp: ['world-wide', 'trustfulnessss', 'humankinds', 'realitys', 'faithss'],
customer experience solutions: ['customer', 'seess', 'havess', 'customersss', 'have'],
designs business solutions: ['intentsss', 'lines', 'contrives', 'jobs', 'contrivesss'],
better customer experience: ['serioussss', 'securess', 'skillful', 'soundsss', 'breaks'],
human leads: ['atomic_number_82s', 'heads', 'pencil_leads', 'pass', 'tips'],
human experiences: ['homo', 'have', 'live', 'lives', 'feels'],
differentiating human touch: ['secernates', 'separatesss', 'partakes', 'bear_upon', 'tint'],
world’s: ['world’ss', 'world’s'],
exciting brands: ['stigma', 'rousess', 'excitess', 'marks', 'firebrand'],
payment services: ['divine_service', 'defraymentss', 'servicing', 'requitals', 'requital'],
range of services: ['scopesss', 'graspsss', 'range', 'orders', 'range_of_mountains'],
Hundreds of brands: ['one_C', 'stigma', 'Hundreds', 'brandsss', '100sss'],
right technology: ['technologyss', 'redressss', 'compensate', 'decent', 'mightilys'],
exciting companies: ['companiess', 'arousess', 'company', 'agitates', 'energises'],
Emotional intelligence: ['aroused', 'emotionals', 'intelligences', 'intelligence_services', 'arousedss'],
lasting impact: ['durable', 'go', 'permanentss', 'lastss', 'touchs'],
powerful impact: ['mighty', 'sinewyss', 'touchs', 'bear_upon', 'bear_ons'],
leading global investment: ['world-wide', 'sphericals', 'heads', 'leavess', 'starss'],
global leadership position: ['world-wide', 'set', 'postures', 'sphericals', 'location'],
Proponuєmo: ['Proponuєmo', 'Proponuєmos'],
social media moderation: ['moderateness', 'relief', 'societalss', 'mixers', 'mass_medium'],
life: ['lifetimes', 'life-times', 'lifetime', 'alivenesss', 'life_sentence'],
customers' hearts: ['substance', 'gists', 'pumps', 'meat', 'nub'],
skill: ['acquirements', 'sciences', 'attainment', 'acquisition', 'accomplishments'],
GBL: ['GBL', 'GBLs'],
European leader: ['drawing_card', 'loss_leader', 'leader', 'European', 'leaderss'],
minds: ['idea', 'mind', 'mindss', 'judgements', 'heads'],
commitment: ['loyaltys', 'dedication', 'committednesss', 'allegiances', 'committedness'],
Job portal: ['lines', 'hepatic_portal_veins', 'Jobs', 'line_of_workss', 'jobs'],
real difference: ['deviations', 'existentss', 'conflict', 'reals', 'literals'],
era of fast connectivity: ['profligate', 'earned_run_averagessss', 'connectivityssss', 'ofsss', 'connectivity'],
table: ['postpone', 'tabularise', 'boards', 'put_off', 'mesa'],
game-changers: ['game-changers', 'game-changerss'],
empathy: ['empathy', 'empathys'],
locations: ['location', 'positions', 'placements', 'position', 'locationss'],
culture: ['finish', 'culture', 'acculturations', 'refinements', 'refinement'],
own and teams: ['own', 'ains', 'have', 'havess', 'possesssss'],
Perfectionist and esthetician: ['Perfectionistss', 'andss', 'aesthetician', 'Perfectionist', 'ands'],
Metrics and KPI Monitoring: ['metricsss', 'metric_functionss', 'metric_functionssss', 'metric_unitsss', 'metricsssss'],
Setting goals and objectives: ['backgroundss', 'scopesss', 'place_settingsss', 'set', 'goal'],
testing and control of their implementation: ['restraintss', 'verify', 'test', 'operatesss', 'implementation'],
Leader and positive motivator: ['overconfidentss', 'confirmingss', 'confirmings', 'leaderss', 'positivessss'],
Setting tasks and monitoring the work of the editor: ['backgroundss', 'scopesss', 'forge', 'makessss', 'adjustsssssssss'],
Setting tasks and monitoring their implementation: ['backgroundss', 'scopesss', 'mise_en_scenessss', 'taxss', 'theirsss'],
Democracy and moderate authoritarianism: ['softens', 'mince', 'centristss', 'moderationists', 'restraineds'],
Ads and Direct Advertising Basics: ['Adssss', 'advertises', 'ads', 'advertizement', 'heads'],
Ability to articulate goals and objectives: ['powers', 'goal', 'end', 'phrasess', 'articulateds'],
draw conclusions and turn them into tasks: ['makessss', 'turn_overss', 'hooking', 'move_around', 'linessss'],
Tracking SEO trends and their implementation: ['swervesss', 'Trackingsssss', 'implementation', 'cut_throughssss', 'driftsss'],
Effective organization and control of your time: ['constitution', 'seessss', 'governing_bodys', 'ascendancyssss', 'sees'],
Ability to work in multi-tasking and continuous problem solving: ['tosssssss', 'forge', 'makessss', 'continuousss', 'powerss'],
The ability to negotiate in high quality and achieve win in them: ['tosssssss', 'deliver_the_goods', 'characterss', 'lineamentsssss', 'powerss'],
The pursuit of large goals and the ability to see the situation: ['tosssssss', 'interestssssssssss', 'avocation', 'bombasticssssss', 'by-liness'],
A positive outlook on the world and the ability to charge them with a team: ['tosssssss', 'tutelages', 'chargessssssssss', 'confirmings', 'amperesssssssssssss'],
It unites the team and together with it goes to the goal: ['tosssssss', 'pass_awayssss', 'soundsss', 'team_up', 'team_upssssss'],
with high: ['heightss', 'senior_high_school', 'gamey', 'high_schools', 'eminents'],
product with team: ['production', 'mathematical_productss', 'team_ups', 'team_up', 'productsss'],
Work with advertisers: ['do_work', 'forge', 'body_of_workss', 'operatesss', 'studys'],
Work with developers: ['do_work', 'forge', 'body_of_workss', 'operatesss', 'studys'],
Will unite with a common goal and will develop its participants: ['uprise', 'risesss', 'explicate', 'rough-cut', 'testaments'],
ability to analyze information: ['powers', 'infos', 'canvasss', 'psychoanalyse', 'information'],
Mon-Fri from: ['froms', 'Mon-Fris', 'fromss', 'from', 'Mon-Fri'],
team work priorities: ['do_work', 'forge', 'squadsss', 'body_of_workss', 'studys'],
Ability to generate ideas: ['powers', 'generatess', 'powerss', 'return', 'engenders'],
The ability to think creatively: ['powers', 'powerss', 'consider', 'recall', 'call_up'],
Creating a family atmosphere in a team: ['createss', 'makessss', 'team_up', 'familysssssss', 'teamsssssss'],
The desire to improve even in small things: ['inwardss', 'in', 'tieds', 'tosssssss', 'affair'],
Creating a team of like-minded people: ['axerophtholsss', 'createss', 'squadsss', 'makessss', 'angstromssss'],
which can build a family atmosphere in a team: ['physiquessss', 'thronessssssss', 'makessss', 'bottomssss', 'sternsssssss'],
hear objective criticism: ['hearss', 'listenss', 'find_outsss', 'literary_criticism', 'documentaryss'],
Ability to build an effective scheme of any process: ['tosssssss', 'physiquessss', 'makessss', 'powerss', 'summonss'],
and create them: ['thems', 'make', 'andss', 'createss', 'ands'],
don't wait for tasks: ['hold_backss', 'delaysss', 'waitings', 'hold_offs', 'postponementsss'],
solution of problems: ['problemssss', 'answersss', 'resolutionsss', 'rootsss', 'ofsss'],
Global thinking: ['world-wide', 'sphericals', 'thinkings', 'consider', 'recall'],
Flexible thinking: ['thinkings', 'consider', 'pliants', 'recall', 'call_up'],
Logical thinking: ['suppose', 'recollects', 'imagine', 'thinkings', 'coherentss'],
Content Creation: ['substance', 'cognitive_content', 'subjects', 'Creation', 'Contentss'],
Willingness to perform linear tasks: ['project', 'analogss', 'linear', 'undertaking', 'executess'],
Attention to details: ['aidss', 'inside_information', 'points', 'caress', 'caresss'],
Time manager: ['time', 'clock_times', 'manager', 'prison_terms', 'clipss'],
years manager: ['geezerhood', 'manager', 'days', 'year', 'long_timess'],
Willingness to change: ['modify', 'changesss', 'commute', 'exchange', 'modifys'],
Excellent understanding: ['fantabulousss', 'infers', 'sympathys', 'realises', 'realise'],
To be able to distinguish good from mediocre: ['secernates', 'tosssssss', 'separatesss', 'soundsss', 'constitutessssss'],
online product promotion: ['production', 'mathematical_productss', 'online', 'productsss', 'promotional_materials'],
dispute resolution: ['conflictss', 'gainsays', 'resolving_powers', 'solvings', 'resolvings'],
The ability to get to the bottom of the issue: ['tosssssss', 'generatess', 'amaze', 'mystifysss', 'makessss'],
Compilation of native-selling ad texts: ['compiling', 'native-sellingssss', 'ads', 'advertizement', 'ofsss'],
you are welcome: ['representss', 'comprisess', 'live', 'lives', 'yousss'],
result: ['ensue', 'final_results', 'final_result', 'resultant', 'solvent'],
constantly improve yourself: ['perpetuallysss', 'constantlys', 'improves', 'yourselfss', 'foreverss'],
competitor analysis: ['rivals', 'competitorss', 'analysisss', 'analysis', 'depth_psychology'],
English Upper-Intermediate or higher: ['ORss', 'sidesss', 'operating_theater', 'gamey', 'English_language'],
authors: ['generators', 'author', 'authors', 'generator', 'sources'],
business processes: ['lines', 'procedures', 'summonss', 'treats', 'jobs'],
analysts: ['analystss', 'psychoanalyst', 'psychoanalysts', 'analyst', 'analysts'],
motivation: ['motivation', 'motivating', 'need', 'motives', 'needs'],
marketing: ['merchandising', 'commercialize', 'marketing', 'market', 'commercialises'],
UAE: ['UAEs', 'UAE'],
Recruiting new employees: ['inscribe', 'Recruitings', 'inscribes', 'inscribess', 'employees'],
Energetic optimist: ['optimist', 'gumptiouss', 'Energeticss', 'energeticss', 'optimistss'],
Good negotiator: ['trade_good', 'securess', 'skillful', 'thoroughlyss', 'upright'],
Personality: ['personalitys', 'Personalitys', 'Personality', 'personality'],
development: ['ontogenys', 'exploitation', 'growth', 'growing', 'evolution'],
Active: ['fightings', 'dynamics', 'active', 'active_agent', 'Active'],
learn new: ['hearss', 'cons', 'studys', 'learns', 'instructs'],
Team player: ['actors', 'Team', 'team_ups', 'team_up', 'participants'],
What will need to be done: ['dones', 'set', 'donessss', 'postulates', 'testaments'],
daily basis: ['casual', 'bases', 'basis', 'base', 'groundwork'],
VMware: ['VMware', 'VMwares'],
operating systems: ['controlss', 'maneuverss', 'go', 'functionss', 'manoeuvress'],
communication skillsAbility: ['skillsAbilitys', 'communication', 'communicating', 'skillsAbility', 'communicatingss'],
once a month: ['oncesss', 'angstrom_unitss', 'erstwhiles', 'one_time', 'amps'],
Paid leave and sick leave: ['ante_up', 'regorges', 'willss', 'payingss', 'farewellss'],
Contract Area: ['abbreviate', 'constrict', 'reducess', 'squeeze', 'squeezes'],
Politeness: ['politeness', 'politenesss', 'civilitys', 'nicenesss', 'Politeness'],
decent salary: ['adequate', 'wage', 'decents', 'comme_il_faut', 'decorousss'],
systemic thinking: ['suppose', 'recollects', 'imagine', 'thinkings', 'means'],
It is important for us: ['U', 'make_upss', 'United_Statess', 'It', 'comprises'],
obov'yazkovo: ["obov'yazkovo", "obov'yazkovos"],
Mon: ['Mon', 'Monday', 'Mons', 'Mondays'],
Fri: ['Fri', 'Fridays', 'Friday', 'Fris'],
data visualization skills: ['skillss', 'datum', 'visualisation', 'information', 'skillsss'],
Strong project management: ['securess', 'unassailabless', 'externalises', 'warms', 'hardsss'],
values: ['appreciate', 'valuess', 'respect', 'treasure', 'prizes'],
high standard of business ethics: ['high_gearsss', 'bannersss', 'bannerssss', 'highssss', 'lines'],
Tableau: ['tableau', 'Tableaus', 'tableau_vivant', 'tableau_vivants', 'Tableau'],
Veon: ['Veons', 'Veon'],
adherence: ['adherence', 'bonds', 'adhesiveness', 'adhesion', 'adhesions'],
Code of conduct: ['computer_codes', 'ofsss', 'write_in_code', 'deportments', 'behave'],
legal obligations: ['duty', 'effectualss', 'obligations', 'effectuals', 'legal'],
upper intermediate: ['pep_pillss', 'intermediate', 'liaises', 'speeds', 'amphetamine'],
compliance policies: ['compliancys', 'conformationss', 'obligingness', 'complaisance', 'policys'],
procedures: ['subroutine', 'routines', 'procedure', 'operation', 'procedures'],
collaborative: ['collaboratives', 'collaborative'],
Main responsibilities: ['main', 'independentss', 'chief', 'primaryss', 'master'],
ambiguous problems: ['problems', 'job', 'problemsss', 'equivocals', 'equivocal'],
pioneering spirit: ['tone', 'intent', 'feels', 'tones', 'looks'],
head office: ['powers', 'mindss', 'heads', 'nouss', 'forefrontss'],
requirements: ['demands', 'requirements', 'demand', 'necessary', 'requisite'],
center: ['gists', 'centers', 'centre_of_attention', 'focus_on', 'shopping_centres'],
verbal: ['verbals', 'verbal'],
report: ['news_report', 'studys', 'write_ups', 'describe', 'report'],
push: ['pushings', 'promotes', 'advertises', 'labours', 'agitates'],
time: ['clock_time', 'fourth_dimension', 'time', 'clip', 'meters'],
improvement: ['meliorations', 'advance', 'improvements', 'melioration', 'improvement'],
California: ['Calif.s', 'Californias', 'California', 'Golden_State', 'CA'],
Gnucci graphik robots: ['Gnuccis', 'graphik', 'Gnuccisss', 'automatons', 'robotsss'],
online chat: ['Old_World_chats', 'Old_World_chat', 'natters', 'online', 'confabs'],
team members: ['team_ups', 'team_up', 'penis', 'team_upss', 'appendages'],
growing team: ['uprise', 'develops', 'maturationss', 'growth', 'uprisess'],
business challenges: ['business_organizations', 'gainsays', 'lines', 'business_enterprises', 'clienteles'],
Github: ['Githubs', 'Github'],
graphic design: ['pictorial', 'pattern', 'project', 'vivid', 'intentions'],
Company: ['company', 'fellowship', 'Company', 'partys', 'party'],
changes: ['modify', 'commute', 'exchange', 'modifys', 'deepens'],
Russian: ['Russian', 'Russians'],
Qualifications: ['Qualificationss', 'reservations', 'making', 'Qualifications', 'reservation'],
Ux: ['Ux', 'Uxs'],
Node: ['lymph_node', 'thickenings', 'client', 'leaf_nodes', 'Node'],
reliability: ['dependability', 'reliableness', 'reliability', 'dependabilitys', 'dependableness'],
USD: ['USD', 'USDs'],
Requirements for a candidate: ['campaigners', 'prerequisitesss', 'essentialss', 'Requirementssss', 'forss'],
corporate parties: ['corporatess', 'incarnates', 'company', 'partiesss', 'collectives'],
modern office: ['powers', 'modern', 'modss', 'innovativess', 'spots'],
Place of work: ['range', 'do_work', 'set', 'orders', 'forge'],
ahrefs: ['ahrefss', 'ahrefs'],
serpstat: ['serpstats', 'serpstat'],
analytic skills: ['skillss', 'analyticss', 'analyticals', 'analytical', 'skillsss'],
Analytical mind: ['idea', 'mind', 'analyticss', 'analyticals', 'mindss'],
SEO: ['SEO', 'SEOs'],
Fri s: ['Fri', 'Fridayss', 'sulphur', 'mhos', 'secs'],
paid leave and sick leave: ['ante_up', 'regorges', 'willss', 'payingss', 'farewellss'],
of customers: ['customerss', 'customers', 'customer', 'ofs', 'client'],
Medical Insurance: ['indemnity', 'medicalss', 'aesculapianss', 'medical_checkup', 'Medical'],
US dollars: ['Americas', 'U.S.A.ss', 'U.S.ss', 'Uss', 'the_Statess'],
Participation: ['engagement', 'involution', 'participation', 'Participations', 'involvements'],
friends: ['booster', 'ally', 'friendss', 'supporter', 'admirers'],
existing customers: ['customer', 'existentss', 'customersss', 'live', 'existing'],
assistance: ['aids', 'assistance', 'help', 'assistances', 'assists'],
night shifts: ['Nightss', 'shiftings', 'breaks', 'sacks', 'wobble'],
employment: ['engagement', 'use', 'utilisations', 'usage', 'utilization'],
referral program: ['programs', 'program', 'course_of_study', 'computer_program', 'programss'],
years: ['geezerhood', 'days', 'year', 'eld', 'geezerhoods'],
teams: ['teams', 'squads', 'team', 'teamss', 'team_ups'],
responsibilities: ['province', 'responsibleness', 'responsibilitys', 'responsibilitiess', 'dutys'],
tickets: ['slates', 'tags', 'just_the_ticket', 'ticketss', 'slate'],
holidays: ['vacations', 'holidays', 'holiday', 'holidayss', 'vacation'],
overtimes: ['extra_time', 'overtimess', 'overtimes', 'overtime', 'extra_times'],
CentOS: ['CentOSs', 'CentOS'],
Redhat: ['Redhat', 'Redhats'],
If you want to take part in interesting world-class projects, join: ['tosssssss', 'separatesss', 'characterss', 'partsssssssss', 'needinessss'],
test cases: ['test', "typesetter's_case", 'casesss', 'display_case', 'trials'],
Android Studio: ['Androids', 'studios', 'mechanical_mans', 'humanoidss', 'humanoids'],
Jira: ['Jiras', 'Jira'],
insurance: ['policy', 'indemnity', 'insurance_policys', 'insurance', 'policys'],
good understanding: ['trade_good', 'securess', 'skillful', 'realises', 'realizes'],
consumer electronics: ['electronics', 'consumers', 'consumerss', 'electronicss', 'consumer'],
date: ['engagement', 'day_of_the_month', 'escorts', 'go_steady', 'particular_date'],
chats: ['Old_World_chats', 'Old_World_chat', 'natters', 'confabs', 'confab'],
Job responsibilities: ['lines', 'Jobs', 'line_of_workss', 'jobs', 'speculates'],
iPad: ['iPads', 'iPad'],
iPhone: ['iPhones', 'iPhone'],
Mindfulness: ['mindfulnesss', 'Mindfulnesss', 'mindfulness', 'Mindfulness', 'heedfulness'],
snacks and game: ['snack', 'mettlesome', 'back', 'gages', 'gamesss'],
comfortable office in Kiev with delicious coffee: ['powerss', 'officesss', 'atomic_number_49s', 'office_staffsss', 'atomic_number_49'],
massage and other amenities: ['rub_downsss', 'amenitiesss', 'creature_comfortss', 'rub_down', 'massages'],
Opportunity for professional growth and career development: ['professionalssss', 'maturationss', 'careers', 'evolutions', 'growthssssss'],
friendly and talented team of like-minded people: ['squadsss', 'hoi_pollois', 'ofsss', 'team_up', 'teamsssssss'],
Learning English at the office: ['powers', 'hearss', 'eruditionsss', 'teachsss', 'Atss'],
How we will inspire you: ['barracks', 'pep_ups', 'testaments', 'leavess', 'willss'],
We are just made for each other.: ['createss', 'makessss', 'onlyssss', 'get_tossss', 'realizes'],
Test Case Writing: ['Test', 'test', 'characterss', "typesetter's_case", 'incasess'],
Modern: ['modern', 'mod', 'Bodoni', 'moderns', 'forward-looking'],
Young: ['young', 'youthful', 'untested', 'immature', 'unseasoneds'],
mini football: ['miniskirtss', 'miniss', 'football', 'mini', 'footballs'],
activity: ['bodily_functions', 'bodily_function', 'natural_process', 'body_processs', 'activenesss'],
Kanban: ['Kanban', 'Kanbans'],
Scrum: ['Scrums', 'Scrum', 'scrummage', 'scrummages', 'scrums'],
city ​​center: ['urban_center', 'cityss', 'urban_centerss', '\u200b\u200bcenter', 'citys'],
Long-term employment: ['engagement', 'semipermanent', 'utilisations', 'long-term', 'usage'],
equipment: ['equipments', 'equipment'],
months: ['calendar_months', 'months', 'calendar_month', 'month', 'monthss'],
Our requirements: ['requirements', 'essential', 'necessity', 'essentials', 'requisite'],
decency: ['decency', 'decencys'],
writing: ['drop_a_line', 'write', 'piece_of_writing', 'written_material', 'spells'],
Scho mi proponєmo: ['stat_mis', 'myocardial_infarcts', 'international_nautical_mile', 'MI', 'Security_Services'],
kava: ['kavakavas', 'kava', 'kavas', 'kavakava'],
Conduct business correspondence with customers: ['proportionatenesssss', 'patronagessss', 'channelss', 'lines', 'linessss'],
Responsibility: ['Responsibility', 'province', 'responsibleness', 'responsibilitys', 'dutys'],
Office in: ['powers', 'inwardss', 'in', 'powerss', 'atomic_number_49s'],
minutes from: ['hour', 'moments', 'arcminute', 'instants', 'bits'],
Full employment: ['engagement', 'utilisations', 'entiress', 'usage', 'utilizations'],
T-sql: ['T-sql', 'T-sqls'],
See us: ['hearss', 'escorts', 'realises', 'U', 'consider'],
mi praciєmo z: ['stat_mis', 'Military_Intelligence_Section_6sss', 'myocardial_infarcts', 'international_nautical_mile', 'knotsss'],
long days: ['yearnss', 'long', 'hankerss', 'retentive', 'daylights'],
Religion holy without vidrapratsyuvannya: ['holys', 'withoutsss', 'faithss', 'holyssss', 'Religionssss'],
all powers: ['powers', 'altogetherss', 'top_executive', 'mights', 'big_businessman'],
lat: ['lat', 'latissimus_dorsis', 'latissimus_dorsi', 'lats'],
Further: ['Further', 'encourages', 'boost', 'Furthers', 'furthers'],
and most importantly: ['to_the_highest_degree', 'nigh', 'most', 'importantlysss', 'nighs'],
Instagram: ['Instagram', 'Instagrams'],
calendar day: ['calendarss', 'daylights', 'days', 'daytimes', 'sidereal_day'],
vacation: ['vacations', 'vacation', 'holidays', 'holiday'],
min: ['Fukien', 'Amoys', 'Hokkianeses', 'Fukkianeses', 'minutes'],
st: ['st', 'sts'],
the first: ['commencement', 'for_the_first_times', 'first_gear', 'first_base', 'thes'],
User support: ['keep_going', 'brook', 'bear_outs', 'affirms', 'support'],
Professional requirements: ['professionals', 'requirements', 'master', 'essential', 'necessity'],
LINQ: ['LINQs', 'LINQ'],
finance: ['finance', 'finances'],
Stress resistance: ['focuss', 'Stress', 'emphasisess', 'tenseness', 'electric_resistance'],
take the fate of the contest for landing: ['makessss', 'learnsssss', 'use_up', 'contestssssssss', 'set_ashore'],
Main vimogi to the candidate: ['campaigners', 'independentssss', 'Mains', 'independentsssss', 'Mainsss'],
Come to the command of the ZhUK: ['tosssssss', 'ZhUKs', 'descendssssss', 'comes', 'bidss'],
Zarobitna pay to consider with a candidate іndivіdualno: ['tosssssss', 'ante_up', 'turn_overss', 'wagess', 'seessss'],
napoleglivіst: ['napoleglivіst', 'napoleglivіsts'],
PC knowledge: ['microcomputerss', 'PC', 'cognition', 'personal_computerss', 'knowledges'],
salary: ['wage', 'earnings', 'salarys', 'salary', 'remuneration'],
inіtsіativnіst: ['inіtsіativnіst', 'inіtsіativnіsts'],
Work schedule with: ['do_work', 'forge', 'body_of_workss', 'operatesss', 'studys'],
Confluence: ['confluxs', 'meeting', 'merging', 'Confluence', 'concourses'],
Of Russia: ['Of', 'Russia', 'Ofss', 'Soviet_Russias', 'Russian_Soviet_Federated_Socialist_Republic'],
leaders: ['drawing_card', 'loss_leader', 'leaderships', 'leader', 'leaderss'],
Git Experience: ['scum_bags', 'Experiencess', 'bumss', 'stinkpots', 'have'],
Mon working schedule: ['do_work', 'forge', 'Mondayss', 'cultivatess', 'exercises'],
with payment twice a month: ['paymentssss', 'defraymentss', 'paymentsssss', 'withs', 'defrayalsss'],
Comfortable and cozy office: ['powers', 'well-situatedsss', 'well-fixedss', 'snugs', 'snugss'],
P in: ['ps', 'in', 'INs', 'p', 'inwardss'],
Bonus and reward system: ['bonus', 'advantages', 'honourss', 'Bonussss', 'payoffss'],
Office in the center of Kiev on the street: ['partsssssssss', 'shopping_mallss', 'powerss', 'snapperss', 'Indianasssssss'],
Friendly team of professionals and interesting tasks every day: ['professionalssss', 'squadsss', 'everyssss', 'everysssssss', 'team_up'],
Leo Tolstoy or m: ['molar_concentrations', '1000s', 'Gs', 'Leo_the_Lion', 'MB'],
Waiting for your resume: ['hold_backss', 'Waitings', 'waitings', 'awaitssss', 'hold_offs'],
University: ['Universitys', 'university', 'universitys', 'University'],
High level Z: ['tieds', 'high_gearsss', 'dismantle', 'take_downss', 'tear_downs'],
opportunities: ['opportunities', 'chance', 'chances', 'opportunitys', 'opportunitiess'],
efficiency: ['efficiencys', 'efficiency'],
language: ['linguistic_process', 'linguistic_communications', 'nomenclature', 'spoken_languages', 'terminologys'],
Rabbitmq: ['Rabbitmq', 'Rabbitmqs'],
Memcached: ['Memcached', 'Memcacheds'],
PHP7: ['PHP7', 'PHP7s'],
Symfony: ['Symfony', 'Symfonys'],
SQS: ['SQS', 'SQSs'],
Technical English: ['Technicalss', 'expert', 'English_language', 'English_peoples', 'proficient'],
office programs: ['powers', 'programs', 'powerss', 'berthss', 'billetss'],
ua: ['uas', 'ua'],
tsilespryamanovіst: ['tsilespryamanovіst', 'tsilespryamanovіsts'],
ofіtsіyne pratsevlashtuvannya: ['ofіtsіyne', 'pratsevlashtuvannyas', 'pratsevlashtuvannyass', 'ofіtsіyness', 'ofіtsіynes'],
spіvrobіtnikіv: ['spіvrobіtnikіvs', 'spіvrobіtnikіv'],
Pіdprimstvo: ['Pіdprimstvos', 'Pіdprimstvo'],
vihіdnі: ['vihіdnіs', 'vihіdnі'],
Livoberezhna: ['Livoberezhnas', 'Livoberezhna'],
UAH from the first month of work: ['commencementsss', 'do_work', 'forge', 'kickoffssss', 'first_base'],
foosball and playstation: ['foosballsss', 'andss', 'ands', 'playstation', 'playstationss'],
Modern furniture and appliances: ['modern', 'Modernsss', 'article_of_furniture', 'gadgets', 'forward-looking'],
Dialogue with potential clients on behalf of the company: ['companysssssss', 'potentialitysssssss', 'dialoguesssssss', 'company', 'potential_drops'],
representative office of a large international holding in Ukraine: ['spokespersonsss', 'powerss', 'officesss', 'atomic_number_49s', 'interpreterssssss'],
comfortable large kitchen with lounge area: ['well-situatedsss', 'magnanimoussssss', 'well-fixedss', 'hang_arounds', 'bombastics'],
This is not network marketing.: ['not', 'notsss', 'make_upss', 'comprises', 'marketing.ssss'],
Therefore, send us your resume faster: ['profligate', 'stations', 'transports', 'United_Statess', 'transmitsssss'],
better call: ['securess', 'shout_out', 'skillful', 'addresss', 'vociferation'],
tea unlimited: ['unlimited', 'unlimiteds', 'tea_leafss', 'straight-out', 'teas'],
bonuses: ['incentive', 'bonus', 'bonuses', 'fillip', 'bonuss'],
pro: ['pro', 'pros', 'professionals', 'professional'],
social networks: ['societalss', 'mixers', 'societal', 'networks', 'societals'],
VK: ['VK', 'VKs'],
problem: ['problems', 'job', 'jobs', 'troubles', 'trouble'],
sales: ['sale', 'sales_agreement', 'gross_revenues', 'cut-rate_sales', 'sales_event'],
if you are: ['ifsss', 'live', 'yousss', 'lives', 'comprises'],
B tests: ['test', 'trials', 'B_vitamins', 'mental_test', 'borons'],
similar position: ['set', 'postures', 'location', 'standardizedss', 'put'],
initiative: ['enterprises', 'opening_move', 'initiatives', 'first_step', 'first'],
a plus: ['plus', 'positives', 'amps', 'ampss', 'asset'],
TypeScript: ['typescripts', 'typescript', 'TypeScripts', 'TypeScript'],
LinkedIn: ['LinkedIns', 'LinkedIn'],
courses and stuff: ['stuffss', 'lines', 'flows', 'coursess', 'overgorge'],
workshops: ['workshops', 'shops', 'workshop', 'workshopss', 'shop'],
We are waiting for you: ['hold_backss', 'waitings', 'make_upss', 'comprises', 'hold_offs'],
English: ['English', 'side', 'English_languages', 'English_language', 'Englishs'],
Competitive salary: ['wage', 'private-enterprises', 'competitoryss', 'salaryss', 'Competitives'],
QA: ['QA', 'QAs'],
support: ['keep_going', 'brook', 'bear_outs', 'affirms', 'support'],
before: ['before', 'ahead', 'earliers', 'aheads', 'in_fronts'],
and staff recruitment: ['recruitments', 'staffs', 'enlisting', 'recruitment', 'staff'],
Understanding and Deployment Experience: ['apprehensionsss', 'Understandings', 'realises', 'savvyss', 'realizes'],
and higher System update experience: ['highssss', 'systemss', 'higherss', 'gameyssss', 'organization'],
Participation in product development and changes: ['modify', 'inwardss', 'in', 'maturationss', 'involution'],
Operational and strategic planning: ['project', 'strategicsss', 'functional', 'be_after', 'provisions'],
RAD and JavaScript Languages: ['JavaScriptss', 'radians', 'linguistic_process', 'linguistic_communications', 'nomenclature'],
for the development and maintenance of Micro Focus SM version system: ['focalizes', 'growingsssssss', 'caress', 'caresss', 'concentresss'],
Failure analysis in systems and tasks: ['inwardss', 'in', 'depth_psychologysssss', 'unsuccessful_personssss', 'unsuccessful_personsss'],
Compliance with SLA and CSI by unit Education and professional experience: ['teachingss', 'SLAssss', 'awayssssss', 'experiencesssssss', 'conformationsss'],
Certification and control of system documentation: ['restraintss', 'verify', 'operatesss', 'credentialssssss', 'enfranchisementss'],
Setting goals and monitoring staff: ['backgroundss', 'scopesss', 'mise_en_scenessss', 'staffssss', 'limit'],
Knowledge of the architecture and scaling principles of the Micro Focus SM system: ['principlessss', 'focalizes', 'Knowledgesss', 'concentresss', 'noesissssssssssssss'],
Basic professional knowledge and skills: ['professionalssss', 'canonicalss', 'pros', 'cognition', 'introductoryssss'],
Experience implementing Micro Focus SM version: ['follow_throughsssss', 'havessssss', 'centersss', 'follow_outsss', 'follow_through'],
at a company that uses the Micro Focus SM version: ['thatssssssssss', 'usagessssss', 'focalizes', 'United_Statess', 'thatsssssss'],
understanding of the structure and principles of operation of internal processes Micro Focus SM: ['principlessss', 'reasonssssss', 'social_systemssss', 'summonss', 'social_structuresss'],
Micro Micro Focus SM System Maintenance: ['centersss', 'centeringssss', 'focalizes', 'centers', 'focusssss'],
information and technical support of all subsystems: ['entropysss', 'keep_going', 'altogetherss', 'brook', 'underpinssss'],
Experience in participating in IT projects: ['inwardss', 'in', 'havessssss', 'externalises', 'activess'],
develops proposals for designers to make changes and additions: ['uprise', 'risesss', 'fashion_designer', 'tosssssss', 'makessss'],
Develops reporting and a single base for training users of information IT systems: ['nucleotide', 'themesssssss', 'formulatesssssssssss', 'breaks', 'evolvesssssssssssss'],
using and implementing standard design solutions; Participation in new Asset integration projects: ['rawssss', 'Modernsss', 'intentionssssss', 'put_throughssss', 'participationssss'],
Deadline changes: ['modify', 'Deadline', 'changesss', 'commute', 'deadlines'],
Certified Micro Focus Certified: ['evidences', 'focalizes', 'centers', 'concenters', 'focalize'],
Work experience in this field no less than: ['playing_areass', 'forge', 'makessss', 'runssssssss', 'sourssssssss'],
Organizational skills teamwork: ['skillss', 'organisationals', 'organisationalsss', 'skillsss', 'skill'],
Development experience: ['maturationss', 'growth', 'have', 'live', 'lives'],
Setting staff development goals: ['backgroundss', 'scopesss', 'maturationss', 'place_settingsss', 'set'],
Building a product knowledge base: ['axerophtholsss', 'makessss', 'nucleotide', 'basis', 'angstromssss'],
systems development: ['growth', 'growths', 'evolutions', 'systemss', 'systems'],
Unit management experience no less than: ['unitsssss', 'nossss', 'no_moresss', 'Nosss', 'unit_of_measurementssssss'],
years work experience: ['do_work', 'forge', 'body_of_workss', 'geezerhood', 'studys'],
customized system: ['custom-makess', 'customize', 'systemss', 'systems', 'organization'],
Resource control: ['verify', 'controlss', 'contains', 'master', 'moderate'],
Full higher IT education: ['full_phase_of_the_moonssss', 'educationsss', 'wide-cutssss', 'broadsss', 'widess'],
Configure Integrations Using: ['integration', 'victimisation', 'configures', 'desegregationss', 'desegregation'],
setting goals: ['backgroundss', 'set', 'goal', 'end', 'mise_en_scenes'],
their algorithmization: ['theirs', 'algorithmizations', 'theirss', 'algorithmization', 'algorithmizationss'],
RESTFul API Apache Tomcat Tuning Experience: ['Apache', 'restfulsss', 'reposefulssssss', 'RESTFul', 'sees'],
SQL knowledge: ['SQLss', 'cognition', 'SQL', 'SQLs', 'knowledges'],
as a process management system: ['axerophtholsss', 'arsenic', 'angstromssss', 'mental_processss', 'arsenicssss'],
Formation of the ITSM Support Department: ['brookss', 'keep_going', 'constitution', 'ITSM', 'brook'],
KPI: ['KPIs', 'KPI'],
organizational: ['organizational', 'organisational', 'organisationals', 'organizationals'],
development: ['ontogenys', 'exploitation', 'growth', 'growing', 'evolution'],
Staff training: ['condition', 'develops', 'staffs', 'cultivate', 'staff'],
very desirable: ['suitables', 'identicals', 'reals', 'identicalss', 'realss'],
Company training: ['company', 'Company', 'party', 'trainingss', 'fellowships'],
leadership skills: ['skillss', 'skillsss', 'skill', 'science', 'leaderss'],
IT investment projects: ['project', 'information_technologyss', 'visualize', 'externalises', 'contrives'],
no less: ['to_a_lesser_extents', 'nobeliumss', 'less', 'Noss', 'nobeliums'],
Vimogi to the candidate: ['campaigners', 'candidatess', 'thes', 'nominee', 'prospects'],
experience with MySQL: ['seess', 'havess', 'have', 'receivesss', 'live'],
Full-time flexible hours: ['elasticss', 'hour', 'pliable', 'Full-time', 'full-time'],
strong knowledge of PHP technologiescure knowledge of SQL: ['securess', 'unassailabless', 'hardsss', 'warms', 'PHPssss'],
ability to understand someone else's code English at the level of reading documentation: ['tosssssss', 'tieds', 'encryptssssss', 'dismantle', 'personssssssss'],
Work on an interesting project: ['forge', 'makessss', 'exercises', 'exercisesssss', 'work_outsss'],
Near the Golden Gate metro: ['cheeseparingss', 'aboutss', 'penny-pinching', 'cheeseparingsss', 'well-nighsssss'],
performance result: ['carrying_outs', 'ensue', 'final_results', 'final_result', 'operations'],
Stresostіykіst: ['Stresostіykіst', 'Stresostіykіsts'],
CSS3: ['CSS3s', 'CSS3'],
We offer: ['bid', 'go', 'volunteer', 'proposes', 'offerss'],
SCSS: ['South_Carolina', 'atomic_number_21', 'SCSS', 'atomic_number_21s', 'South_Carolinas'],
Fruit: ['Fruits', 'fruit', 'yield', 'yields', 'Fruit'],
working day with: ['do_work', 'forge', 'operatesss', 'cultivatess', 'gosss'],
statistical analysis: ['analytic_thinkings', 'statisticals', 'psychoanalysis', 'analysisss', 'statistical'],
internal systems: ['home', 'intragroup', 'interiorss', 'intragroupss', 'national'],
difference: ['deviations', 'remainders', 'divergence', 'departures', 'deviation'],
fast-paced environment: ['fast-paceds', 'environment', 'fast-paced', 'surround', 'environs'],
London: ['capital_of_the_United_Kingdom', 'Greater_Londons', 'capital_of_the_United_Kingdoms', 'London', 'Londons'],
You are welcome: ['representss', 'comprisess', 'live', 'lives', 'make_upss'],
Viber: ['Vibers', 'Viber'],
Decent pay: ['adequate', 'wage', 'decents', 'ante_up', 'comme_il_faut'],
HTML5: ['HTML5', 'HTML5s'],
Proficiency: ['Proficiency', 'technique', 'proficiency', 'proficiencys', 'techniques'],
architecture: ['architecture', 'computer_architectures', 'architectures', 'computer_architecture'],
Experience: ['have', 'live', 'lives', 'feels', 'Experiences'],
Svn: ['Svns', 'Svn'],
version control systems: ['restraintss', 'verify', 'systemss', 'organization', 'interlingual_renditionsss'],
Europe: ['EC', 'EEC', 'European_Economic_Communitys', 'Europe', 'Common_Market'],
Chicago: ['Michigans', 'boodle', 'Windy_Citys', 'stops', 'Newmarkets'],
specialists: ['specialistss', 'specialisers', 'specializer', 'specialists', 'medical_specialists'],
working days: ['do_work', 'forge', 'cultivatess', 'exercises', 'daytime'],
Microsoft SQL Server Practitioner C: ['hostss', 'practicianss', 'host', 'nose_candys', 'practitionerss'],
modern: ['modern', 'mod', 'Bodoni', 'moderns', 'forward-looking'],
statistics: ['statisticss', 'statistics', 'statistic'],
GPO: ['United_States_Government_Printing_Offices', 'United_States_Government_Printing_Office', 'US_Government_Printing_Offices', 'Government_Printing_Offices', 'Government_Printing_Office'],
VPN: ['VPN', 'VPNs'],
vіdkritimi to new ідей: ['vіdkritimi', 'ідейss', 'New', 'newsss', 'ідейsss'],
open to new ideas and talents: ['rawssss', 'Modernsss', 'heart-to-heartsssss', 'afford', 'open'],
the first Ukrainian betting company and part of the international holding company FavBet: ['characterss', 'partsssssssss', 'kickoffssss', 'number_1ssss', 'breaks'],
We are experienced and well known: ['have_sex', 'equalsssss', 'make_upss', 'sleep_with', 'comprises'],
however, we remain steadfast: ['withalss', 'wesss', 'all_the_same', 'we', 'nevertheless'],
years: ['geezerhood', 'days', 'year', 'eld', 'geezerhoods'],
leader of the sports entertainment industry: ['frolic', 'skylarkss', 'ofsss', 'features', 'frisk'],
Work in the grocery: ['inwardss', 'in', 'do_work', 'forge', 'body_of_workss'],
operationally and logistically: ['logistically', 'andss', 'logisticallyss', 'ands', 'logisticallysss'],
fresh and on: ['sassys', 'reinvigoratedsss', 'tonicsss', 'refresheds', 'refreshedss'],
Food-tech company Raketa with Head Office in Kiev and an office in the Dnieper: ['psychessssssssss', 'partsssssssss', 'officesssssssssssss', 'nouss', 'powerss'],
the best in its market technically: ['soundsss', 'atomic_number_49s', 'securities_industry', 'dependablesssss', 'commercialises'],
An incredibly cool and ambitious project: ['externalises', 'contrives', 'proposes', 'AN', 'unbelievablyssss'],
We connect online with offline: ['link', 'plug_intossss', 'touch_basess', 'withs', 'relatesss'],
This makes ordering and delivery of delicious meals for our customers convenient and easy: ['causessssssssssss', 'createss', 'puddlessssss', 'arrangessssssssssss', 'crapsssssssssssss'],
We create a company: ['createss', 'company', 'produces', 'party', 'fellowships'],
We want to be the shortest distance between every local restaurant and the customer's door: ['tosssssss', 'localssssss', 'costssssssssssss', 'needinessss', 'localsssssssssss'],
Food-tech companies: ['companiess', 'company', 'fellowship', 'companies', 'Food-tech'],
Join this incredible journey with Raketa: ['link', 'unitesssss', 'junctionssssss', 'incrediblesss', 'travelss'],
Raketa's goal is to deliver faster: ['deliverss', 'goal', 'end', 'profligate', 'extraditess'],
Ability to work part-time remotely: ['powers', 'do_work', 'forge', 'part-times', 'body_of_workss'],
allowing our users to order their favorite food through our mobile apps or website: ['tosssssss', 'edicts', 'nutrient', 'appssssssss', 'edictssssssss'],
Loyal management: ['loyals', 'truehearteds', 'truehearted', 'Loyalss', 'fastss'],
Dynamically developing team of experienced specialists: ['uprise', 'risesss', 'uprisess', 'dynamicallyssss', 'originatessss'],
paid holiday calendar days: ['calendarss', 'ante_up', 'devotes', 'make_upss', 'holidayss'],
audio data: ['audioss', 'datum', 'sound_recordingss', 'information', 'sound_recording'],
CMS Advisory Services: ['consultative', 'centimeters', 'consultatoryss', 'curiumss', 'advisorys'],
CMS Outsourcing: ['Outsourcing', 'CMS', 'centimetres', 'Outsourcings', 'centimeters'],
advanced algorithms: ['modern', 'come_along', 'forward-looking', 'advancedss', 'come_onss'],
superior experience: ['higher-upss', 'victors', 'master', 'have', 'live'],
Software Solutions: ['software_programss', 'software_system', 'solvent', 'software_programs', 'Solutionsss'],
great products: ['keen', 'dandys', 'large', 'peachyss', 'not_badss'],
maximum CMS efficiency: ['maximals', 'CMS', 'utmostsss', 'maximal', 'centimetres'],
basic software development skills: ['maturationss', 'canonicalss', 'evolutions', 'software_programs', 'growings'],
company growthUnlimited tea: ['callerss', 'company', 'callersss', 'teas', "ship's_companyss"],
India: ['Bharats', 'Republic_of_India', 'Indias', 'Bharat', 'Republic_of_Indias'],
growth opportunity: ['maturationss', 'growth', 'growths', 'growthss', 'opportunityss'],
Singapore: ['Singapore_Islands', 'Republic_of_Singapores', 'Singapore', 'Singapore_Island', 'Singapores'],
integrated world-class Credit Management Services: ['accreditss', 'mergedsssss', 'foremostss', 'mixsss', 'mentionsss'],
world-class Code of Ethics: ['computer_codes', 'foremostss', 'ofsss', 'write_in_code', 'encryptss'],
Debt Purchasing: ['debts', 'Debts', 'Purchasings', 'buying', 'Debt'],
Comfortable office: ['well-situateds', 'powers', 'spots', 'prosperousss', 'well-to-doss'],
version control: ['verify', 'sees', 'reading', 'control_condition', 'translationss'],
debt solution: ['debts', 'result', 'results', 'solution', 'solvents'],
salary expectations: ['wage', 'earningsss', 'wagess', 'expectation', 'anticipations'],
integrated product offering: ['proposes', 'mixsss', 'incorporates', 'bids', 'desegregatesss'],
non-performing consumer loans: ['lends', 'non-performing', 'lend', 'consumersss', 'loanssss'],
stringent set of operational risk control processes: ['adventuress', 'gambless', 'summonss', 'situatedssss', 'determinedssss'],
Requirements3: ['Requirements3s', 'Requirements3'],
distributed computing: ['circularise', 'circularisess', 'spread', 'disperses', 'dish_outss'],
voice: ['vox', 'representative', 'vocalisation', 'interpreter', 'interpreters'],
KyivFriendly: ['KyivFriendlys', 'KyivFriendly'],
motivated team: ['promptss', 'prompt', 'team_ups', 'team_up', 'incites'],
pioneer: ['open_ups', 'open_up', 'groundbreakers', 'initiates', 'trailblazers'],
optimal outcome: ['final_results', 'final_result', 'resultant', 'outcomes', 'optimumss'],
debtor: ['debtor', 'debitors', 'debitor', 'debtors'],
creditor: ['creditor', 'creditors'],
right person: ['mortal', 'redressss', 'compensate', 'decent', 'mightilys'],
Southeast Asia: ['SE', 'Southeasts', 'SEs', 'south-east', 'southeastwards'],
flexible working hours: ['do_work', 'forge', 'cultivatess', 'exercises', 'pliants'],
Functional responsibilities: ['Functional', 'functional', 'workings', 'duty', 'workingss'],
Mon.: ['Mon.s', 'Mon.'],
competitors: ['contender', 'competitorss', 'rivals', 'challengers', 'competitions'],
Regular revision of wages: ['rescriptsss', 'wagess', 'evenss', 'ofsss', 'wag'],
TeamCity: ['TeamCity', 'TeamCitys'],
flexible work schedule: ['do_work', 'forge', 'body_of_workss', 'studys', 'cultivatess'],
countries: ['body_politic', 'countries', 'nation', 'rural_areas', 'body_politics'],
networks: ['network', 'electronic_network', 'meshworks', 'mesh', 'networks'],
sports Hall: ['vestibule', 'frolic', 'mansion', 'skylarkss', 'Radclyffe_Halls'],
debugging: ['debuggings', 'debug', 'debugging', 'debugs'],
market: ['securities_industrys', 'commercializes', 'mart', 'securities_industry', 'food_market'],
Selenium: ['seleniums', 'Selenium', 'Seleniums', 'atomic_number_34', 'Se'],
state: ['United_States_Department_of_State', 'body_politic', 'posits', 'submits', 'put_forward'],
services: ['divine_service', 'servicing', 'overhauls', 'avail', 'armed_service'],
ones: ['oness', 'aces', 'one', 'Is', 'unitys'],
Scala: ['Scala', 'Scalas'],
Higher education: ['teaching', 'eminentss', 'Department_of_Education', 'gamey', 'eminents'],
we will offer it for your consideration: ['testaments', 'leavess', 'willss', 'proposes', 'bequeaths'],
Higher Education: ['teaching', 'eminentss', 'Department_of_Education', 'gamey', 'eminents'],
Who we are: ['WHOs', 'live', 'lives', 'WHOsss', 'comprises'],
Mocha: ['Mochas', 'mochas', 'mocha_coffees', 'mocha_coffee', 'mocha'],
CD: ['cadmium', 'CDs', 'compact_disc', 'cds', 'compact_disk'],
software: ['softwares', 'computer_softwares', 'software_system', 'package', 'software_systems'],
databases: ['databasess', 'databases', 'database'],
table tennis: ['postpone', 'put_overss', 'deferss', 'tabularise', 'boards'],
Good knowledge: ['trade_good', 'securess', 'skillful', 'thoroughlyss', 'upright'],
discounts: ['push_aside', 'discount_rate', 'dismisss', 'ignores', 'brush_offs'],
ElasticSearch: ['ElasticSearch', 'ElasticSearchs'],
startups: ['startup', 'inaugurations', 'startupss', 'startups', 'inauguration'],
English classes: ['sort', 'courses', 'assorts', 'course_of_study', 'English_language'],
experience: ['go_throughs', 'experiences', 'receives', 'knows', 'have'],
lifetime allowance: ['lifetimes', 'life-times', 'valuation_reserves', 'allowance', 'lifetime'],
Knowledge of information security system: ['entropysss', 'information', 'ofsss', 'systemss', 'Knowledgesss'],
Law of Ukraine: ['Ukrayina', 'lawsss', 'jurisprudences', 'natural_laws', 'constabularysss'],
About information: ['just_abouts', 'nigh', 'infos', 'most', 'Abouts'],
Of the Constitution of Ukraine: ['constitution', 'Constitutionsss', 'ofsss', 'Constitution_of_the_United_States', 'organization'],
bonuses and compensation under the article: ['bonusesssssss', 'underssss', 'bonuses', 'underss', 'recompensesss'],
On information security in information and telecommunication systems: ['inwardss', 'in', 'entropysss', 'information', 'indiumssss'],
organizesmanages activities and means of protection of information in NADS: ['entropysss', 'sheltersssss', 'protective_cover', 'atomic_number_49s', 'selective_informations'],
ensuring the functioning of a comprehensive information security system: ['entropysss', 'guaranteessss', 'seessss', 'selective_informations', 'sees'],
that needs protection: ['postulates', 'needs', 'motivations', 'requires', 'protective_cover'],
orally and in writing: ['inwardss', 'in', 'by_word_of_mouthss', 'written_material', 'spells'],
Communication and interaction: ['Communications', 'Communication', 'fundamental_interaction', 'interactions', 'Communicationss'],
Ability to listen to thought: ['powers', 'hearss', 'mindss', 'thinkings', 'persuasion'],
On approval of the Regulation on the National Agency of Ukraine for Civil Service: ['favourable_receptionsssss', 'regulations', 'officesss', 'approvalsssssss', 'ordinancessssssssss'],
adopted in the NADS: ['inwardss', 'in', 'take_upssss', 'adoptss', 'espousesss'],
relevant to the Sector's competence: ['competencessss', 'thes', 'competencesss', 'competences', 'relevant'],
containing information: ['hold_backss', 'controlss', 'contains', 'infos', 'comprisess'],
to argue and present them: ['deliverss', 'awards', 'lay_out', 'fence', 'indicatess'],
Ability to listen and perceive thoughts: ['powers', 'hearss', 'mindssss', 'mindss', 'thinkings'],
office equipment and other equipment within the scope of tasks: ['scopesss', 'backgroundss', 'partsssssssss', 'powerss', 'officesss'],
according to which the protection of information in automated systems should be ensured: ['tosssssss', 'entropysss', 'tributessssss', 'sheltersssss', 'automateds'],
Resolution of the Cabinet of Ministers of Ukraine of: ['Cabinetsss', 'resolving_powersss', 'firmnesssss', 'solvings', 'Ministerssss'],
Orientation to the result: ['ensue', 'thes', 'final_results', 'final_result', 'predilection'],
On the prevention of corruption: ['thes', 'corruptnesss', 'prevention', 'ofsss', 'putrescences'],
take measures to provide organizational and administrative management of user access to resources: ['tosssssss', 'put_upssssssss', 'resourcesssss', 'bringsssssssss', 'admitssss'],
Chief Information Security Officer Structural Division: ['Chiefsss', 'segmentations', 'entropysss', 'tribal_chiefssss', 'heads'],
containing the information provided: ['hold_backss', 'information', 'comprises', 'containingssss', 'incorporates'],
related to the tasks and content of the job of a civil servant according to the job description: ['tosssssss', 'associatessssssssssssssssss', 'touchssssssssssssssssss', 'messagessss', 'linessss'],
provisions on the structural unit: ['viandsssss', 'victualsssss', 'unitsssss', 'viandsss', 'provisions'],
within the framework of the NADS: ['NADs', 'insidesssss', 'theoretical_accountsss', 'insidesss', 'thes'],
Willingness to share experiences and ideas: ['partakes', 'percentage', 'experiencesssssss', 'ploughsharess', 'shares'],
organizes and performs computer hardware maintenance work: ['organisesssssss', 'forge', 'caress', 'exercises', 'sustainment'],
fluency in the state languageLeague requirements1: ['inwardss', 'in', 'indiumssss', 'positsss', 'State'],
Orientation to team result: ['team_up', 'resultss', 'outcomes', 'team_upss', 'team'],
monitors users' compliance with information security policy requirements: ['proctorsss', 'entropysss', 'policyssssss', 'information', 'Monitor'],
which encourage the occupation of the chosen position: ['set', 'postures', 'military_controlss', 'lines', 'location'],
prompt intervention in their work when trying to gain unauthorized access to resources: ['tosssssss', 'runssssssss', 'exploitsssssssss', 'actuatessssssss', 'intercessionssssssss'],
the protection requirements of which are established by applicable law: ['makessss', 'tributessssss', 'sheltersssss', 'essentialsssss', 'protective_cover'],
Knowledge of the law: ['knowledgessss', 'lawsss', 'jurisprudences', 'cognitionsss', 'natural_laws'],
Completion of the task in full in due time: ['completionssss', 'duesssssssss', 'taxss', 'widess', 'atomic_number_49s'],
Orientation to the end results: ['end', 'goal', 'terminals', 'endings', 'resultss'],
A clear vision of his mission in a elected position in a state body: ['readablessssssssss', 'authorisessssss', 'straighten_outsssssss', 'officesss', 'statussss'],
openness in information sharing: ['inwardss', 'in', 'receptivenessssss', 'information', 'partakes'],
with changes: ['modify', 'changesss', 'commute', 'exchange', 'modifys'],
with changes: ['modify', 'changesss', 'commute', 'exchange', 'modifys'],
Knowledge of special legislation: ['knowledgessss', 'especialss', 'statute_laws', 'cognitionsss', 'cognitions'],
participates in the development of draft regulatory and regulatory documents: ['written_documents', 'enlists', 'Indianasssssss', 'growingsssssss', 'Inssssss'],
components of information security policy: ['entropysss', 'component_part', 'information', 'elementss', 'ofsss'],
bachelor's degreeExperience: ["bachelor'sss", "bachelor'ss", 'degreeExperiencess', 'degreeExperience', 'degreeExperiences'],
Ability to make suggestions: ['powers', 'createss', 'craps', 'makessss', 'suggestions'],
Higher education is not lower than a bachelor's degree: ['teachingss', 'frowns', 'gamysssssssss', 'lowssss', 'low-spiritedss'],
does not need a command of the official language: ['makessss', 'comes', 'officialssssss', 'bidss', 'exercises'],
network peripherals: ['peripheralsss', 'networks', 'peripherals', 'meshss', 'peripheral_devices'],
Issues of remuneration of employees of state bodies: ['military_issuessss', 'wagess', 'return', 'publishsssssss', 'State'],
Ability to establish logical relationships: ['powers', 'coherentss', 'powerss', 'establishsssss', 'legitimatess'],
Ability to draw correct conclusions: ['hooking', 'powerss', 'draw_insss', 'take_in', 'thread'],
Understanding key factors: ['cays', 'apprehensionsss', 'tonalityss', 'paints', 'Understandings'],
to speak clearly: ['clearlysss', 'speak', 'addresss', 'understandablys', 'verbalise'],
January: ['Jans', 'Januarys', 'January', 'Jan'],
Alena Lobenko: ['Lobenkoss', 'Alenas', 'Lobenko', 'Alenass', 'Alena'],
surcharges: ['overcharge', 'fleece', 'surcharges', 'overcharges', 'gazump'],
Professional knowledge1: ['pros', 'professionals', 'professional', 'masters', 'knowledge1ss'],
Motivation: ['motivation', 'Motivations', 'Motivation', 'motivating', 'need'],
allowances: ['margin', 'valuation_account', 'adjustment', 'allowancess', 'valuation_reserves'],
challenging project: ['externalises', 'contrives', 'challenges', 'proposes', 'thought-provoking'],
оur project: ['project', 'visualize', 'externalises', 'оur', 'contrives'],
market salary: ['wage', 'securities_industrys', 'grocery_storess', 'commercializes', 'mart'],
case of project success: ['characterss', 'successsss', 'externalises', "typesetter's_case", 'incasess'],
development of independent: ['main', 'maturationss', 'independentss', 'growth', 'developmentsss'],
development of like-minded team: ['maturationss', 'developmentsss', 'growth', 'maturationssss', 'team_ups'],
project of international standard: ['jutsss', 'externalises', 'contrives', 'stick_outsss', 'ofsss'],
long-term world-class project: ['project', 'semipermanent', 'visualize', 'long-term', 'externalises'],
fixed salary: ['desexualizes', 'set', 'securess', 'mends', 'repairss'],
code standards development: ['computer_codes', 'developmentsss', 'ciphers', 'growth', 'inscribe'],
PHP framework: ['frameworks', 'PHP', 'PHPss', 'fabric', 'theoretical_account'],
successful experience: ['successfulss', 'have', 'live', 'lives', 'feels'],
necessary experience: ['requirements', 'have', 'essentialss', 'live', 'essential'],
professional level: ['degree', 'tieds', 'professionals', 'rases', 'even_outs'],
good English level: ['trade_good', 'tieds', 'serioussss', 'securess', 'skillful'],
team creation: ['Creation', 'team_ups', 'team_up', 'instauration', 'initiations'],
global level: ['world-wide', 'tieds', 'sphericals', 'dismantle', 'tear_downs'],
interview: ['question', 'interviews', 'questions', 'audiences', 'consultations'],
good communication: ['trade_good', 'securess', 'skillful', 'thoroughlyss', 'upright'],
code review: ['computer_codes', 'ciphers', 'inscribe', 'code', 'critical_review'],
presentation skills: ['skillss', 'display', 'introductionss', 'presentment', 'skillsss'],
permanent training: ['condition', 'develops', 'permanentss', 'cultivate', 'training'],
companies interaction: ['fundamental_interaction', 'companiess', 'callerss', 'company', 'interactions'],
wage supplements: ['wage', 'earningsss', 'add_on', 'accessory', 'add-on'],
best technologies: ['securess', 'skillful', 'Charles_Herbert_Bests', 'C._H._Bests', 'Charles_Herbert_Bestss'],
modern features: ['modern', 'modss', 'innovativess', 'feature_articles', 'boasts'],
fair wage: ['bazaarss', 'wage', 'justss', 'fair', 'funfairs'],
professional value: ['professionals', 'appreciate', 'valuess', 'master', 'respect'],
adequate company: ['passables', 'adequate', 'fair_to_middlings', 'decents', 'company'],
a leading network company: ['axerophtholsss', 'company', 'angstromssss', 'heads', 'leavess'],
employees orientation support: ['keep_going', 'brook', 'bear_outs', 'affirms', 'support'],
required functionality: ['needfulss', 'expectss', 'necessitate', 'mandatoryss', 'postulates'],
advantageWe offer: ['bid', 'advantageWes', 'go', 'volunteer', 'proposes'],
KISS: ['snogs', 'busss', 'candy_kiss', 'osculate', 'osculation'],
hundreds of thousands: ['yard', 'one_C', '100sss', 'ofsss', 'thousands'],
detailed documentation: ['software_documentations', 'details', 'detailss', 'certifications', 'support'],
REST API: ['reliefss', "catch_one's_breathss", 'respitess', 'rest_period', 'rest_periods'],
refactoringAre: ['refactoringAres', 'refactoringAre'],
teamwork control: ['verify', 'controlss', 'contains', 'master', 'moderate'],
tuition: ['tutelages', 'tuition_fees', 'tutorships', 'tutelage', 'tuition_fee'],
choice: ['quality', 'prize', 'pick', 'qualitys', 'selections'],
huge database: ['immensess', 'hugess', 'database', 'vastss', 'huge'],
candidate: ['campaigners', 'nominees', 'nominee', 'candidate', 'campaigner'],
unique visitors: ['singular', 'unparalleledss', 'unequaleds', 'unparalleleds', 'unequaled'],
new online services: ['Modernsss', 'freshly', 'Service', 'Robert_William_Services', 'raws'],
demand: ['requirements', 'necessitate', 'postulates', 'needs', 'necessitates'],
words: ['news', 'Good_Book', "actor's_lines", 'Holy_Writ', 'intelligences'],
Company's expense: ["Company's", 'disbursements', 'expense', 'disbursals', 'write_off'],
tech task: ['project', 'undertaking', 'technical_schoolss', 'labors', 'jobs'],
HEADWAY: ['head', 'HEADWAY', 'headroom', 'headway', 'heads'],
metro: ['metros', 'tubes', 'metro', 'tube', 'subway'],
compensation system: ['recompensess', 'systemss', 'systems', 'organization', 'arrangements'],
cool product: ['coolheaded', 'production', 'cools', 'chillss', 'cool_offss'],
basis: ['fundaments', 'foundation', 'bases', 'footing', 'base'],
MVP: ['most_valuable_players', 'MVPs', 'most_valuable_player', 'MVP'],
western Europe: ['Europes', 'European_Economic_Community', 'European_Community', 'ECs', 'western_sandwich'],
X3: ['X3s', 'X3'],
opinion: ['rulings', 'popular_opinions', 'judgements', 'persuasion', 'impression'],
startup: ['inaugurations', 'startups', 'startup', 'inauguration'],
Our staff: ['Our', 'staffss', 'staffs', 'staff', 'stave'],
Work in a team of professionals: ['forge', 'makessss', 'team_up', 'exercises', 'exercisesssss'],
the unfinished higher: ['baress', 'thes', 'gamey', 'eminents', 'higherss'],
working days: ['do_work', 'forge', 'cultivatess', 'exercises', 'daytime'],
Official employment from the first working day: ['forge', 'usagessssss', 'Officialssssss', 'first_base', 'officialssssss'],
Software development cycle: ['maturationss', 'evolutions', 'software_programs', 'pedals', 'growingss'],
software requirements preparation: ['requirements', 'software_programss', 'software_system', 'provisions', 'essentialss'],
corporate level platformsOpportunities: ['tieds', 'corporatesss', 'dismantle', 'take_downss', 'tear_downs'],
salary growthCorporate English coursesFlexible: ['wage', 'coursesFlexibles', 'earningsss', 'growthCorporatessss', 'wagess'],
devicesInternational projects: ['project', 'visualize', 'externalises', 'contrives', 'undertaking'],
experienceRequirements: ['experienceRequirements', 'experienceRequirementss'],
external services: ['divine_service', 'servicing', 'overhauls', 'outsides', 'avail'],
SCRUMDesign patterns knowledgeWe offer: ['approach_pattern', 'proposes', 'pass', 'model', 'SCRUMDesign'],
scheduleComfortable office: ['powers', 'spots', 'bureaus', 'power', 'business_office'],
application of Agile: ['diligencesss', 'application_program', 'applications_programme', 'practical_applicationsss', 'ofsss'],
ready system releaseOpportunity: ['set', 'fixss', 'setss', 'systemss', 'systems'],
new technologies: ['technologiess', 'engineering_sciences', 'New', 'technologys', 'newlys'],
analytical thinking: ['suppose', 'recollects', 'imagine', 'analyticss', 'analyticals'],
Flexible schedule: ['Flexibles', 'elasticss', 'pliable', 'scheduless', 'compromisings'],
Fast growing hi-tech company: ['uprise', 'maturationss', 'uprisess', 'risesss', 'profligate'],
fusion reactors: ['spinal_fusion', 'mergers', 'spinal_fusions', 'nuclear_reactor', 'optical_fusions'],
control systems: ['restraintss', 'verify', 'systemss', 'organization', 'checkss'],
China: ['Taiwan', 'mainland_China', 'china', 'Communist_China', 'Nationalist_China'],
telescopes200: ['telescopes200s', 'telescopes200'],
humanity's biggest projects: ['bighearted', 'swelleds', 'externalises', 'freehanded', 'full-grown'],
Switzerland: ['Schweiz', 'Svizzeras', 'Switzerlands', 'Suisse', 'Swiss_Confederations'],
necessarily: ['needss', 'needfullys', 'inevitably', 'of_necessity', 'inevitablys'],
Basic requirements: ['stapless', 'requirements', 'Basicss', 'canonicalss', 'Basic'],
analytical mind: ['idea', 'mind', 'analyticss', 'analyticals', 'mindss'],
contextual advertising: ['promotes', 'advertising', 'advertises', 'advertisement', 'ads'],
Eldorado Company: ['company', 'fellowship', 'Company', 'eldoradoss', 'El_Dorado'],
VPR: ['VPR', 'VPRs'],
at the level of a confident user: ['tieds', 'dismantle', 'Atssss', 'dismantlesssss', 'Asss'],
literate speech: ["actor's_lines", 'literate_persons', 'spoken_languages', 'addresss', 'speech_communications'],
month: ['calendar_month', 'month', 'months', 'calendar_months'],
Experience in: ['inwardss', 'in', 'Experiencess', 'INs', 'seess'],
TelegramShow phone: ['phoness', 'rings', 'TelegramShows', 'speech_sounds', 'phone'],
Clubs: ['golf_club', 'night_clubs', 'orders', 'nightclubs', 'nightspot'],
Boardgames: ['Boardgames', 'Boardgamess'],
ViberShow phoneReply: ['ViberShows', 'ViberShowss', 'phoneReply', 'phoneReplys', 'phoneReplyss'],
ZONE3000: ['ZONE3000', 'ZONE3000s'],
non-functional: ['non-functionals', 'non-functional'],
cookies: ['biscuit', 'cookys', 'cookiess', 'cookie', 'cookies'],
hospital: ['infirmarys', 'hospitals', 'hospital', 'infirmary'],
training: ['condition', 'develops', 'cultivate', 'training', 'prepares'],
Literate oral and written speech: ['literate_persons', 'spoken_languages', 'addresss', 'spells', 'literatessss'],
A decent level of remuneration: ['axerophtholsss', 'tieds', 'decentlyssss', 'angstromssss', 'comme_il_faut'],
it: ['IT', 'ITs', 'it', 'information_technologys', 'information_technology'],
Important: ['significant', 'crucials', 'of_imports', 'Important', 'of_import'],
Pragmatic Play Company: ['spiel', 'frolic', 'company', 'fiddles', 'bidss'],
Intermidate English: ['English', 'side', 'Intermidates', 'Intermidate', 'Intermidatess'],
web applications: ['application_program', 'applications_programme', 'World_Wide_Web', 'networks', 'WWW'],
Web TechnologiesExperience: ['World_Wide_Web', 'TechnologiesExperiencess', 'networks', 'WWW', 'Web'],
Professional skills: ['skillss', 'professionals', 'master', 'skillsss', 'skill'],
advantageGeneral skills: ['skillss', 'acquirements', 'sciences', 'advantageGeneral', 'acquisition'],
Quick understanding: ['warms', 'realises', 'speedys', 'realizes', 'quicklyss'],
CMSGood knowledge of SQL: ['knowledgessss', 'SQLss', 'cognitionsss', 'cognitions', 'ofsss'],
basic Linux command line interface: ['channelss', 'canonicalss', 'linessss', 'personal_credit_line', 'bidss'],
Mongo DB queriesExperience: ['dBss', 'DBss', 'element_105s', 'dB', 'queriesExperiences'],
utilitiesManage: ['utilitiesManage', 'utilitiesManages'],
modern officeUnlimited coffee: ['modern', 'modss', 'innovativess', 'coffee_berry', 'forward-lookingsss'],
monitor systems: ['proctor', 'admonishers', 'monitor_lizardss', 'Monitor', 'systemss'],
reading: ['Reading', 'meter_readings', 'studys', 'recitation', 'show'],
world leader: ['world-wide', 'humankinds', 'realitys', 'Earth', 'leaderss'],
results-oriented specialist: ['specialistss', 'specialisers', 'specializer', 'specialists', 'medical_specialists'],
supportExperience: ['supportExperiences', 'supportExperience'],
solutions: ['result', 'results', 'solution', 'solvents', 'roots'],
JSONExperience: ['JSONExperience', 'JSONExperiences'],
speaking: ['speechmakings', 'speak', 'addresss', 'verbalise', 'oral_presentations'],
writing: ['drop_a_line', 'write', 'piece_of_writing', 'written_material', 'spells'],
talented professionals: ['giftedss', 'pros', 'professionals', 'professional', 'masters'],
game industry: ['mettlesome', 'back', 'gages', 'bet_onss', 'manufactures'],
heart-deep commitment: ['heart-deep', 'commitmentss', 'heart-deeps', 'loyaltys', 'dedication'],
administrating: ['administrating', 'administrate', 'administrates', 'administer', 'administers'],
pressureUnderstanding of SDLC: ['ofs', 'pressureUnderstandingss', 'SDLCsss', 'ofss', 'ofsss'],
scripting: ['scripts', 'scripting', 'script', 'scriptings'],
Zabbix: ['Zabbixs', 'Zabbix'],
Dell: ['dells', 'dell', 'dingle', 'dingles', 'Dell'],
cookies: ['biscuit', 'cookys', 'cookiess', 'cookie', 'cookies'],
Ability to work remotely: ['powers', 'do_work', 'forge', 'body_of_workss', 'studys'],
formal employment: ['engagement', 'evening_gownss', 'utilisations', 'statelyss', 'usage'],
Higher technical education: ['in_high_spiritssss', 'educationsss', 'eminentss', 'teaching', 'Department_of_Education'],
please: ['delight', 'pleases', 'please', 'delights'],
marketing: ['merchandising', 'commercialize', 'marketing', 'market', 'commercialises'],
vacancy: ['emptiness', 'voids', 'void', 'vacuums', 'vacancy'],
unique content: ['singular', 'substance', 'cognitive_content', 'subjects', 'uniquess'],
operation of ventilation and air conditioning systems: ['breathingsssss', 'aviationss', 'mathematical_processsssssss', 'airsss', 'military_operationss'],
Ensure uninterrupted and reliable operation of mobile and fixed line facilities: ['channelss', 'continuousss', 'doctorsss', 'linessss', 'guaranteessss'],
and providing electricity metering by regional network facilities: ['plysssssss', 'leavesssssss', 'leavess', 'catersssssss', 'meteringssss'],
Ensuring the reliability of regional network facilities: ['securess', 'ofsss', 'guaranteessss', 'seessss', 'guarantee'],
operation and maintenance of these network objects: ['maintenancessss', 'mental_processss', 'surgical_operationsssss', 'procedures', 'ofsss'],
or specialized training and experience in the telecommunications network at least: ['operating_theatresssssssssss', 'experiencesssssss', 'take_aimsss', 'operating_theatersssssssss', 'civilisesssssssss'],
Ensuring the reliability of fire protection systems at the objects of the network of the region: ['dischargess', 'give_noticesssssssss', 'flamessssss', 'trade_protectionssssssssss', 'tributessssss'],
Know the basic provisions for the construction and operation of energy supply facilities: ['twistsssssss', 'victualsssss', 'free_energysss', 'screwssssss', 'canonicalss'],
Prepares proposals and performs tasks to improve the reliability of equipment and reduce costs: ['tosssssss', 'propositionsssssssss', 'organisesssssss', 'costssssssssssss', 'makessss'],
Responsible for ensuring fire safety when performing work and equipment: ['dischargess', 'forge', 'actingssss', 'flamessssss', 'workssssssssss'],
telecommunication equipment: ['equipments', 'telecom', 'equipmentss', 'telecoms', 'telecommunications'],
in the designated area: ['inwardss', 'in', 'assigns', 'assignss', 'indiumssss'],
years in energy or telecommunications: ['inwardss', 'in', 'free_energysss', 'geezerhood', 'zipsss'],
Category B car driving rights: ['atomic_number_5ssss', 'ride', 'Categorysssss', 'Bsss', 'impulsives'],
Experience in safe operation of electrical equipment is desirable: ['Indianasssssss', 'experiencesssssss', 'Inssssss', 'atomic_number_49s', 'seessss'],
experience of their service: ['ofsss', 'theirsss', 'their', 'seessss', 'havesss'],
Secondary specialized technical education in the field of energy: ['teachingss', 'playing_areass', 'Secondaryssssssss', 'atomic_number_49s', 'particularizessss'],
Implementation of development plans: ['maturationss', 'implementation', 'be_after', 'programs', 'contrives'],
related to power supply: ['link', 'powers', 'kings', 'provisions', 'powerss'],
Have an electrical safety qualification group not lower than III: ['deliverss', '3', 'frowns', 'makessss', 'experiencesssssss'],
operated personally: ['controlss', 'maneuverss', 'go', 'functionss', 'manoeuvress'],
mobile hardware complexes: ['ironwaress', 'nomadicss', 'peregrines', 'fluidsss', 'peregrinesss'],
installation: ['inductions', 'facilitys', 'initiation', 'installment', 'facility'],
modernization: ['modernisations', 'modernizations', 'modernization', 'modernisation'],
Suprovіd agreement: ['understandings', 'Suprovіd', 'agreements', 'agreement', 'Suprovіds'],
Rbs: ['Rbs', 'Rbss', 'atomic_number_37', 'Rb', 'atomic_number_37s'],
Meta plant: ['founds', 'set', 'engraft', 'flora', 'plant'],
AGG: ['AGG', 'AGGs'],
Nrp: ['Nrps', 'Nrp'],
About us: ['Abouts', 'aboutss', 'U', 'United_Statess', 'USA'],
flexible schedule: ['elasticss', 'pliable', 'scheduless', 'compromisings', 'pliant'],
Adobe illustrator: ['adobe_bricks', 'adobe_brick', 'adobess', 'Adobe', 'Adobess'],
getting started with: ['generatess', 'amaze', 'mystifysss', 'engendersss', 'comes'],
hours a week: ['hour', 'amps', 'workweeks', 'weeksss', 'hrs'],
What will be necessary to do: ['set', 'testaments', 'Whatsssss', 'berylliumss', 'leavess'],
stress resistance: ['focuss', 'emphasisess', 'tenseness', 'electric_resistance', 'tensenessss'],
announces a competition for a vacancy: ['axerophtholsss', 'angstromssss', 'contenderssss', 'herald', 'foretellss'],
focus on quality performance of duties: ['characterss', 'centersss', 'centeringssss', 'rivetsssss', 'focalizes'],
communication skills: ['skillss', 'skillsss', 'skill', 'science', 'sciences'],
retail business: ['business_organizations', 'lines', 'business_enterprises', 'clienteles', 'business_organization'],
Analytical mind: ['idea', 'mind', 'analyticss', 'analyticals', 'mindss'],
day and night shifts: ['Nightss', 'shiftings', 'daylightssss', 'breaks', 'sacks'],
you see yourself in our team: ['learnsssss', 'team_up', 'realizes', 'take_in', 'come_across'],
If after reading this vacancy: ['studys', 'thissss', 'recitation', 'recitals', 'learns'],
summary: ['drumhead', 'succincts', 'compendious', 'compendiouss', 'summary'],
technology stacks: ['technologyss', 'engineeringss', 'wadss', 'flocks', 'engineering'],
Lambda: ['Lambdas', 'lambda', 'Lambda', 'lambdas'],
meetings of technology communities: ['foregather', 'technologyss', 'gathersss', 'meetingsss', 'meetingssss'],
Experienced colleagues: ['colleague', 'fellow_worker', 'seess', 'havess', 'colleagues'],
different countries: ['body_politic', 'dissimilars', 'countries', 'nation', 'body_politics'],
Professional development: ['professionals', 'growth', 'master', 'growths', 'masterss'],
comfort of specialists: ['comfortsss', 'consolations', 'specialistssss', 'puffss', 'ofsss'],
different roles: ['roless', 'dissimilars', 'rolesss', 'function', 'differentss'],
development centers: ['maturationss', 'centersss', 'gists', 'centers', 'evolutions'],
convenient corporate services: ['corporatess', 'divine_service', 'corporatesss', 'servicing', 'incarnatess'],
Study: ['field_of_study', 'canvasss', 'subjects', 'studys', 'consider'],
Friendly atmosphere: ['favorable', 'Friendly', 'air', 'ambiences', 'atmospheress'],
concern: ['fears', 'business_organizations', 'relate', 'business_organization', 'headaches'],
courses: ['courses', 'lines', 'path', 'course_of_study', 'flows'],
practice of English: ['pattern', 'drills', 'practicess', 'praxissss', 'rehearsesss'],
micromanagement: ['micromanagements', 'micromanagement'],
Support of speakers: ['brookss', 'keep_going', 'brook', 'confirmsss', 'bear_outs'],
conferences: ['conferences', 'conferencess', 'group_discussions', 'conference', 'league'],
within a reasonable: ['insidesss', 'amps', 'fair', 'fairish', 'ampss'],
Office in g: ['powers', 'inwardss', 'in', 'federal_agencysss', 'gramme'],
depending on the professional level of the candidate: ['professionalssss', 'tieds', 'pointssss', 'campaigners', 'calculatesssssss'],
determined by interview results: ['driven', 'set', "make_up_one's_mindsss", 'regulate', 'specifysss'],
Flexible motivation system and professional growth opportunity: ['professionalssss', 'maturationss', 'motivationsssss', 'Flexiblessssss', 'needs'],
not a task performer: ['axerophtholsss', 'not', 'notsss', 'taxss', 'jobs'],
a developer of services and video conferencing systems requires a developer: ['video', 'conferencings', 'servingssssss', 'videoss', 'type_Assssss'],
Flexible work schedule: ['do_work', 'forge', 'body_of_workss', 'studys', 'cultivatess'],
the company: ['company', 'thes', 'fellowship', 'partys', 'party'],
Strong experience: ['securess', 'unassailabless', 'solids', 'warms', 'hards'],
Cd processes: ['procedures', 'atomic_number_48ss', 'summonss', 'treats', 'cds'],
Lotteries: ['drawing', 'Lotteriess', 'lotterys', 'drawings', 'lottery'],
separate team: ['secernates', 'fall_apart', 'split_up', 'dividess', 'team_up'],
team of DevOps Engineers: ['locomotive_engineers', 'squadsss', 'DevOpss', 'Engineerss', 'team_ups'],
Cd methodologies: ['cadmium', 'CDs', 'compact_disc', 'atomic_number_48ss', 'cds'],
network fundamentals: ['fundamentals', 'networks', 'basic_principle', 'fundamental_frequency', 'meshss'],
setup integration: ['setup', 'apparatus', 'integration', 'desegregations', 'frame-upss'],
network services: ['divine_service', 'servicing', 'overhauls', 'avail', 'armed_service'],
Gaming machines: ['simple_machine', 'Gamingss', 'back', 'gages', 'bet_onss'],
customer’s processes: ['mental_process', 'procedures', 'summonss', 'treats', 'customer’sss'],
process of customization products: ['mental_processss', 'procedures', 'summonss', 'treats', 'ofsss'],
tuning solution performance: ['tune_up', 'carrying_outs', 'tunes', 'answerss', 'tuning'],
firewalls: ['firewallss', 'firewalls', 'firewall'],
Bash: ['sock', 'whap', 'smash', 'whops', 'bangs'],
SVNStrong scripting skills: ['skillss', 'SVNStrongss', 'scripting', 'skillsss', 'skill'],
production environments: ['production', 'surround', 'environmentsss', 'outputss', 'product'],
stage: ['degree', 'stagecoachs', 'microscope_stage', 'points', 'present'],
Solid foundation: ['basis', 'instauration', 'groundworks', 'upstandings', 'grounding'],
Vcs technologies: ['engineering', 'technologiess', 'engineerings', 'engineering_sciences', 'Vcs'],
networks administration: ['presidency', 'government', 'disposals', 'establishments', 'government_activitys'],
Perl: ['Perls', 'Perl'],
SSL: ['SSL', 'SSLs'],
Https: ['HTTPs', 'hypertext_transfer_protocols', 'hypertext_transfer_protocol', 'HTTP', 'Httpss'],
routing: ['routing', 'expels', 'spread-eagles', 'rout_out', 'routs'],
subnetting: ['subnetting', 'subnettings'],
Uat: ['Uat', 'Uats'],
regulated segments: ['regularise', 'baffle', 'regularisess', 'determine', 'orders'],
DHCPKnowledge of Java programming languages: ['computer_programings', 'programs', 'linguistic_communications', 'spoken_languages', 'terminologys'],
app technology: ['technologyss', 'apps', 'engineerings', 'engineering_sciences', 'engineering_science'],
servers: ['host', 'hosts', 'serverss', 'waiters', 'waiter'],
DSL: ['DSLs', 'digital_subscriber_lines', 'digital_subscriber_line', 'DSL'],
channels: ['channelize', 'channelss', 'lines', 'transmits', 'communication_channel'],
Jboss: ['Jboss', 'Jbosss'],
TLS: ['thallium', 'thalliums', 'Tl', 'atomic_number_81s', 'Tls'],
pipelines: ['grapevine', 'pipeline', 'pipeliness', 'lines', 'pipelines'],
Ansiblehands: ['Ansiblehandss', 'Ansiblehands'],
Poker: ['stove_poker', 'Pokers', 'fire_hook', 'stove_pokers', 'poker'],
Bingo: ['lottos', 'Bingo', 'kenos', 'beano', 'keno'],
favorite games: ['preferredss', 'darlingss', 'back', 'gages', 'gamesss'],
highest standards of service: ['bannersss', 'highssss', 'ofsss', 'gameyssss', 'highests'],
Monday to Friday from: ['Fri', 'Fridayss', 'Monsss', 'Mondayss', 'Fridayssss'],
Work for RESULT: ['do_work', 'forge', 'body_of_workss', 'operatesss', 'studys'],
not the process: ['mental_process', 'not', 'nots', 'thes', 'procedures'],
Design according to Labor Code Work in a comfortable office in a friendly: ['tosssssss', 'runssssssss', 'encryptssssss', 'officesss', 'inventionssssssssssss'],
young team: ['young', 'youthful', 'Thomas_Youngss', 'untested', 'team_up'],
STABLE SALARY AND PREMIUM Photography in the resume is required: ['stablessssssss', 'wagess', 'ANDssssssss', 'STABLE', 'atomic_number_49s'],
WORKPLACE: ['WORKPLACE', 'works', 'work', 'workplaces', 'WORKPLACEs'],
positive: ['plus', 'prescribed', 'positivist', 'positives', 'convinced'],
eg: ['eg', 'egs'],
Friendly: ['well-disposeds', 'favorable', 'Friendly', 'favorables', 'well-disposed'],
five day work week: ['5', 'vss', 'do_work', 'forge', 'body_of_workss'],
Knowledge of SQL: ['SQLss', 'cognitionsss', 'cognitions', 'ofsss', 'Knowledgesss'],
the main thing: ['main', 'independentss', 'things', 'chief', 'mainsss'],
domains: ['knowledge_base', 'domainss', 'fields', 'orbit', 'domain_of_a_functions'],
nationality on the result: ['ensue', 'thes', 'nationalityssss', 'final_results', 'final_result'],
vmіnnya pratsyuvati with great volumes of English documents: ['volumessssssss', 'capitalssss', 'written_documents', 'keen', 'dandys'],
ksh: ['kshs', 'ksh'],
motivation: ['motivation', 'motivating', 'need', 'motives', 'needs'],
Fields: ['field_of_study', 'theatre', 'subjects', 'landing_field', 'studys'],
Mon-Fri from: ['froms', 'Mon-Fris', 'fromss', 'from', 'Mon-Fri'],
video: ['telecastings', 'televisions', 'video', 'television', 'pictures'],
client on the project to complete tasks on time: ['tosssssss', 'dischargess', 'jutsss', 'nailss', 'taxss'],
vmіnnya pratsyuvati in the team: ['vmіnnyas', 'vmіnnyass', 'in', 'INs', 'inwardss'],
Outlook: ['mind-sets', 'mind-set', 'expectations', 'prospect', 'lookout'],
Spring cloud: ['spring', 'overcasts', 'take_a_hop', 'recoilss', 'jumpss'],
Spring rest: ['spring', 'take_a_hop', 'recoilss', 'jumpss', 'rest_period'],
HTML: ['hypertext_markup_language', 'HTML', 'hypertext_mark-up_language', 'hypertext_mark-up_languages', 'HTMLs'],
Robot in a good team: ['trade_good', 'inwardss', 'in', 'golemss', 'axerophtholsss'],
I will ask a programmer for a robot: ['iodinesssss', 'testaments', 'willss', 'Issss', 'robotssssssss'],
Vimogi to candidates_Obov’yazkovo knowledge: ['knowledgessss', 'cognitions', 'candidates_Obov’yazkovo', 'Vimogis', 'cognition'],
Knowledge of the English language on reading the technical documentation: ['sidesss', 'recitation', 'recitals', 'Knowledgesss', 'English_peoplesssssss'],
Preparedness to vidryadzhen for the cordon: ['preparednessss', 'readinesssssss', 'forsss', 'vidryadzhenssssss', 'thes'],
SVNLinux on the main admin interface: ['main', 'mainssss', 'brinysss', 'independentss', 'mainsss'],
Ofis roztashanov at the address: ['come_up_to', 'Ofiss', 'Atss', 'speak', 'atsssss'],
at stars: ['headliners', 'Atss', 'aces', 'asterisk', 'starss'],
Detailed information behind the phone: ['phoness', 'entropysss', 'information', 'fundamentss', 'rumpsss'],
then we’ll prepare vivchity in the process of working with us: ['organisesssssss', 'forge', 'makessss', 'Indianasssssss', 'summonss'],
Windows is not Victorian: ['windowpanessss', 'not', 'notsss', 'make_upss', 'comprises'],
you don’t know: ['have_sex', 'have_it_aways', 'live', 'yousss', 'cognizes'],
In the summary: ['succincts', 'inwardss', 'in', 'INs', 'INss'],
Propono good mind for professional development: ['nouss', 'soundsss', 'listenss', 'judgmentss', 'Proponosss'],
Bajano dosvіd rozrobki dodatkіv pііd Android: ['Bajanos', 'Androidsss', 'dodatkіvssss', 'dodatkіv', 'Androidssss'],
zku s rozvitkom project: ['entropysss', 'externalises', 'southwardss', 'contrives', 'proposes'],
CVS: ['CVs', 'resumes', 'curriculum_vitae', 'resume', 'curriculum_vitaes'],
SpringData JPA: ['SpringData', 'JPAss', 'SpringDatas', 'JPAs', 'SpringDatass'],
Netbeans: ['Netbeans', 'Netbeanss'],
Competitive payroll pay: ['wage', 'ante_up', 'private-enterprisesss', 'devotes', 'free-enterprisesss'],
package zgіdno KZpP Ukraine: ['parcels', 'Ukrayina', 'software_programss', 'software_system', 'box'],
The power of carrots: ['powers', 'kings', 'powerss', 'mogulsss', 'Daucus_carota_sativas'],
Jboss: ['Jboss', 'Jbosss'],
Ejb: ['Ejbs', 'Ejb'],
XSLT: ['XSLT', 'XSLTs'],
Official employment from the first day of work in the company: ['usagessssss', 'forge', 'kickoffssss', 'Officialssssss', 'first_base'],
Do you want to work in: ['forge', 'makessss', 'needinessss', 'comes', 'exercises'],
Negotiating with customers over the phone: ['phoness', 'phone', 'call_up', 'withs', 'negotiate'],
incoming calls and applications for connection from the site: ['call_inss', 'addresss', 'vociferationsssssss', 'telephonesssssss', 'bidss'],
stylish and modern office: ['powers', 'modern', 'forward-looking', 'advancedss', 'officesss'],
Do you have experience in sales from: ['deliverss', 'makessss', 'comes', 'experiencesssssss', 'take_in'],
leading telecom operator for business in Ukraine: ['leadingsssss', 'telecommunication', 'atomic_number_49s', 'business_sectorss', 'contribute'],
Develop long-term customer relationships: ['uprise', 'semipermanent', 'uprisess', 'risesss', 'originatessss'],
companies and sell the most useful product on the market: ['aboutss', 'well-nighsssss', 'sellss', 'securities_industry', 'commercialises'],
Now in our friendly team we are looking for a B2B sales manager: ['straight_offsssssssssssss', 'Indianasssssss', 'team_up', 'team_upssssss', 'Inssssss'],
Work with a hot customer base: ['forge', 'makessss', 'nucleotide', 'exercises', 'exercisesssss'],
Know how to set goals and achieve results: ['tosssssss', 'screwssssss', 'experiencesssssss', 'sleep_with', 'situatedssss'],
our managers get: ['amaze', 'sticks', 'comes', 'bewilders', 'buzz_offs'],
Binotel: ['Binotel', 'Binotels'],
What do our sales managers do: ['set', 'makessss', 'coiffessss', 'sales_event', 'coiffuressss'],
send your resume: ['stations', 'transports', 'sketch', 'airsss', 'postsss'],
You definitely won't have to be bored: ["won'ts", 'deliverss', 'tosssssss', 'havessssss', 'decidedlyss'],
Do not hesitate: ['set', 'not', 'comes', 'notsss', 'bashss'],
we have our own training department: ['deliverss', 'havessssss', 'makessss', 'give_birthsssss', 'ains'],
You are our perfect candidate: ['campaigners', 'perfectss', 'perfect_tense', 'make_upss', 'gross'],
And also fun corporate events: ['funssss', 'corporatesss', 'also', 'outcomes', 'likewisessss'],
if: ['ifs', 'if'],
Free professional training: ['dischargess', 'unfreezess', 'justifys', 'detacheds', 'sparesss'],
month: ['calendar_month', 'month', 'months', 'calendar_months'],
Thank you for your attention: ['Thankssss', 'forsss', 'Thanks', 'yours', 'Thank'],
Cozy: ['tea_cosy', 'cosy', 'intimate', 'informal', 'tea_cosys'],
straight: ['directlys', 'flats', 'full-strength', 'flat', 'straightforward'],
Ability to work with information: ['powers', 'do_work', 'forge', 'body_of_workss', 'operatesss'],
ability to work with promotion channels: ['channelss', 'forge', 'makessss', 'powerss', 'transports'],
internet marketer: ['traffickers', 'cyberspacess', 'internet', 'vender', 'trafficker'],
Ability to work with the target audience.: ['audience.sssssss', 'tosssssss', 'forge', 'makessss', 'powerss'],
Skills for working with contextual advertising and other promotion methods: ['forge', 'makessss', 'advertises', 'runssssssss', 'sourssssssss'],
Organization and automation of the email newsletter system: ['constitution', 'formationssssssss', 'mechanizations', 'ofsss', 'e-mail'],
Creation and publication of materials on the web: ['materialsssss', 'stuffss', 'textile', 'World_Wide_Web', 'ofsss'],
Distribution of Internet Marketing Budget by Internet Channels: ['channelss', 'Internetsss', 'lines', 'Marketingsss', 'distributionssss'],
organize it and analyze: ['mastermindssss', 'studys', 'unionizessss', 'mastermindss', 'devisessss'],
Formation and regular maintenance of an effective base of contractors: ['constitution', 'nucleotide', 'fundamentss', 'caress', 'caresss'],
be part of an ambitious and young team: ['separatesss', 'characterss', 'contributionsssssss', 'percentage', 'Thomas_Youngss'],
Regular reporting and reporting upon management request: ['accountsss', 'reportagessss', 'evenss', 'reportingsss', 'habituessss'],
Email Marketing Skills: ['netmailsss', 'emailss', 'Marketingsss', 'Email', 'commercializes'],
by phone: ['phoness', 'bys', 'aside', 'rings', 'away'],
Luckylook: ['Luckylook', 'Luckylooks'],
Additional questions can be asked on weekdays from: ['extrassssssss', 'wonderssssss', 'bottomssss', 'querysss', 'fundamentss'],
which specializes in professional selection of sunglasses and hats: ['Indianasssssss', 'Inssssss', 'atomic_number_49s', 'particularizessss', 'specialisess'],
Knowledge of languages ​​for the layout of web pages: ['Pages', 'linguistic_communications', 'spoken_languages', 'linguistic_communicationsssss', 'World_Wide_Web'],
Ensuring a high level of conversion of Internet resources of the Company: ['tieds', 'eminentssssssssss', 'dismantle', 'spiritual_rebirthssssss', 'gamysssssssss'],
Business Model Development Skills: ['mannequin', 'maturationss', 'patronagessss', 'postures', 'Businessss'],
improve your professional knowledge every day implementing the most creative ideas: ['daylightssss', 'aboutss', 'put_throughssss', 'improves', 'improvessssssssss'],
Organization of filling the subscription base with target Clients: ['constitution', 'fill_ups', 'nucleotide', 'fundamentss', 'satiatesssssss'],
Now our team has a position: ['deliverss', 'team_up', 'nowadaysss', 'take_in', 'features'],
years occupies a leading position in the Ukrainian market: ['engrosss', 'geezerhood', 'use_up', 'geezerhoodssss', 'leadingsssss'],
comfortable class A office: ['powers', 'well-situatedsss', 'separatesss', 'well-fixedss', 'officesss'],
this is a successful retail company: ['axerophtholsss', 'company', 'angstromssss', 'thissss', 'equalsssss'],
minutes walk from m: ['walkingsss', 'take_the_air', 'paseos', 'base_on_ballsss', 'proceedingsssss'],
Maria: ['mares', 'mare', 'Calophyllum_longifoliums', 'maria', 'Marias'],
Pochayna: ['Pochaynas', 'Pochayna'],
Shopping Center Plaza: ['shop_atss', 'shopss', 'tell_onsss', 'shopping_mallss', 'gists'],
The brand: ['stigma', 'stigmatizes', 'brand_name', 'trade_names', 'stigmatises'],
Performance Indicators of Functionality of OSS Systems: ['os', 'Indicatorsssss', 'Functionality', 'indicant', 'executionsssss'],
Ensuring effective implementation of processes in OSS systems: ['Oss', 'summonss', 'guaranteessss', 'atomic_number_49s', 'seessss'],
vimog group of companies VEON is strictly strategic development of OSS systems: ['Oss', 'constitutessssss', 'strictlyss', 'developmentssssssssssss', 'grouping'],
technical functions and processes: ['mappingsss', 'operatesss', 'affair', 'procedures', 'summonss'],
Development test for real estate processes in OSS systems: ['existentsssss', 'mental_testssss', 'runssssssss', 'Oss', 'summonss'],
Viznacha strategic development of systems for operating systems operating processes: ['growingsssssss', 'summonss', 'evolutionsssssss', 'in_operationss', 'processes'],
Knowledge in part of the OSS of telecomunication operator systems: ['separatesss', 'characterss', 'partsssssssss', 'contributionsssssss', 'characterssssssss'],
Vivcha Global Trends and Standard Development of OSS systems between the groups of companies VEON: ['world-wide', 'veerssssssss', 'sphericals', 'Oss', 'sheerssssssss'],
Formє of a proposal for optimizing budget development of OSS systems: ['Oss', 'type_Assssss', 'oculus_sinister', 'budgetsss', 'Asss'],
Knowledge of hardware platforms and operating systems: ['programs', 'ofsss', 'platformsss', 'systemss', 'Knowledgesss'],
Knowledge of the basic business processes of telecomunication: ['patronagessss', 'mental_processss', 'lines', 'canonicalss', 'procedures'],
Zabezpechuє development and modernization of OSS systems Odyssey one by one to strategic plans: ['tosssssss', 'Odysseys', 'Oss', 'growingsssssss', 'Issss'],
that piece of Intellect: ['piece', 'ofsss', 'tack', 'spells', "objet_d'art"],
Zagalna meta posadi: ['Zagalnasss', 'Zagalna', 'posadiss', 'metass', 'metasss'],
modernization of operations in operation: ['inwardss', 'in', 'mental_processss', 'procedures', 'ofsss'],
what you’ve got to do with them, but they’ve been sold at their base: ['causessssssssssss', 'tosssssss', 'nucleotide', 'amazesssssss', 'comes'],
Rosumіnnya navichki zasosuvannya algorithmіv sampling the great ob'єmіv Danih: ['navichkissssssss', 'samples', 'keen', 'dandys', 'navichkisssssss'],
Visa process: ['mental_process', 'visas', 'Visass', 'procedures', 'summonss'],
Organizational testing and analysis of indicators of effectiveness: ['depth_psychologysssss', 'test', 'essaysssss', 'indicant', 'ofsss'],
rock in the galaxy telecom: ['inwardss', 'in', 'Galax_urceolatas', 'shakesssss', 'rock_candysssss'],
bazhano at the roller of the project: ['rolling_wavessss', 'Atss', 'externalises', 'rollssss', 'contrives'],
so i fixed sound: ['thereforesss', 'desexualizes', 'set', 'securess', 'reasoned'],
The food is technical at the Galuzi Telecommunication Technology or Information Technology: ['nutrient', 'engineeringss', 'Telecommunicationsssss', 'constitutessssss', 'telecommunication'],
Organizational Advice: ['advice', 'organisational', 'organisationals', 'organisationalss', 'organizationalss'],
dosvіd design robots: ['project', 'pattern', 'intentions', 'contrives', 'automaton'],
The basic knowledge of the architecture of today's telecomunication as a mobile: ['canonicalss', 'atomic_number_33ss', 'telecomunicationssss', 'Mobile_Rivers', 'Asss'],
Bazhanavnavnost certification of professional core project: ['professionalssss', 'Congress_of_Racial_Equality', 'externalises', 'credentialssssss', 'contrives'],
Organizational Issues: ['put_outs', 'return', 'outcomes', 'organizational', 'issuing'],
skills of negotiation: ['skillss', 'sciencesss', 'accomplishmentsss', 'dialogues', 'skillsss'],
rozroblyaє plan closely for the results of analysis: ['closelys', 'programs', 'be_after', 'tightssss', 'contrives'],
PMP: ['PMPs', 'PMP'],
Big data: ['bighearted', 'Bigs', 'swelleds', 'freehanded', 'full-grown'],
English: ['English', 'side', 'English_languages', 'English_language', 'Englishs'],
Vilnius Volodinnya: ['Volodinnyass', 'capital_of_Lithuania', 'capital_of_Lithuanias', 'Vilno', 'Vilniusss'],
ETOM: ['ETOMs', 'ETOM'],
Machine learning: ['simple_machine', 'cons', 'studys', 'motorcars', 'learns'],
dali: ['Salvador_Dali', 'dali', 'Salvador_Dalis', 'Dalis', 'dalis'],
machine run: ['simple_machine', 'test', 'range', 'flows', 'scat']
}